Gender,Bank_Loan,Capital_Loan,Region_Code,Year,Total_Loan
M,43350000,1360000,4211000000,2023,44710000
F,42890000,19150000,4111100000,2020,62040000
M,10000,16380000,4399000000,2023,16390000
M,25230000,22000000,4146510700,2022,47230000
M,26130000,1710000,4273000000,2022,27840000
F,27160000,19030000,4146510700,2023,46190000
M,40360000,7210000,4291000000,2020,47570000
M,30110000,1320000,4111100000,2020,31430000
M,4460000,7170000,4111100000,2024,11630000
F,47610000,21070000,4273000000,2021,68680000
M,10790000,19530000,4280000000,2024,30320000
M,12310000,21060000,4111100000,2020,33370000
M,560000,14740000,4211000000,2023,15300000
M,13720000,28540000,4279000000,2021,42260000
F,40110000,9080000,4111100000,2023,49190000
M,10150000,4880000,4279000000,2024,15030000
F,650000,21740000,4146510700,2022,22390000
F,44340000,19530000,GANGWON,2023,63870000
F,800000,2320000,4280000000,2024,3120000
M,9320000,17930000,4399000000,2024,27250000
F,5020000,9870000,GYEONGGI,2024,14890000
M,11550000,29560000,4280000000,2022,41110000
F,20810000,15230000,GYEONGGI,2022,36040000
F,26760000,8170000,4146510700,2022,34930000
F,15430000,23940000,4280000000,2021,39370000
F,35640000,7690000,4399000000,2022,43330000
F,39540000,28470000,GYEONGGI,2022,68010000
F,10340000,7050000,4273000000,2022,17390000
F,26620000,5440000,4211000000,2023,32060000
F,32380000,6070000,4280000000,2022,38450000
M,6200000,190000,4146510700,2021,6390000
M,44100000,1920000,4111100000,2024,46020000
F,12830000,4790000,4399000000,2023,17620000
F,30640000,9200000,GYEONGGI,2020,39840000
F,12120000,19890000,GYEONGGI,2022,32010000
M,23110000,11600000,4211000000,2024,34710000
F,27750000,3800000,GYEONGGI,2024,31550000
M,43620000,16500000,4279000000,2023,60120000
M,43400000,970000,4291000000,2020,44370000
M,46380000,29840000,4279000000,2021,76220000
M,28040000,4030000,GYEONGGI,2024,32070000
M,18640000,22190000,4399000000,2024,40830000
F,27510000,550000,4280000000,2024,28060000
F,45510000,610000,4146510700,2024,46120000
F,15850000,440000,4111100000,2023,16290000
F,12150000,8220000,4280000000,2020,20370000
F,43540000,16110000,4273000000,2024,59650000
M,46410000,12230000,4280000000,2021,58640000
F,13980000,13640000,4280000000,2021,27620000
F,40950000,27040000,4146510700,2022,67990000
M,24720000,21920000,4211000000,2024,46640000
F,47840000,5120000,GYEONGGI,2024,52960000
M,20270000,22670000,4211000000,2024,42940000
F,27530000,17320000,4273000000,2024,44850000
M,45620000,29770000,GANGWON,2024,75390000
F,5400000,22670000,4111100000,2021,28070000
F,28200000,3640000,4279000000,2020,31840000
M,4150000,10460000,4111100000,2020,14610000
M,46020000,8380000,GYEONGGI,2022,54400000
M,29480000,12950000,4111100000,2021,42430000
M,33350000,19670000,4291000000,2024,53020000
M,23160000,21820000,4279000000,2020,44980000
M,37190000,11550000,4273000000,2023,48740000
M,3280000,7900000,GYEONGGI,2023,11180000
M,17450000,17790000,4399000000,2023,35240000
F,48510000,270000,4273000000,2024,48780000
F,22190000,530000,4291000000,2024,22720000
M,44880000,5270000,4279000000,2022,50150000
F,20220000,18640000,4146510700,2022,38860000
F,8430000,16220000,4291000000,2022,24650000
F,15140000,9200000,4273000000,2023,24340000
F,15460000,27770000,GYEONGGI,2024,43230000
M,31770000,26480000,GANGWON,2023,58250000
F,22220000,26080000,GYEONGGI,2022,48300000
M,13600000,29870000,4279000000,2024,43470000
F,1370000,1120000,GANGWON,2021,2490000
F,29010000,10200000,4211000000,2020,39210000
F,40900000,4590000,4279000000,2020,45490000
M,1430000,5090000,4279000000,2022,6520000
F,35210000,13050000,4291000000,2023,48260000
M,34090000,23730000,GYEONGGI,2021,57820000
F,26730000,29590000,4273000000,2024,56320000
M,16370000,22790000,4146510700,2023,39160000
F,39380000,20250000,4111100000,2022,59630000
M,11210000,28700000,4280000000,2023,39910000
M,23680000,29310000,4146510700,2022,52990000
F,30220000,15940000,4111100000,2020,46160000
M,44440000,11040000,4211000000,2020,55480000
F,40100000,4640000,4273000000,2023,44740000
F,24560000,10530000,GYEONGGI,2021,35090000
F,10990000,8890000,4399000000,2024,19880000
F,40920000,28600000,4279000000,2022,69520000
F,26260000,9010000,4146510700,2024,35270000
F,39990000,2020000,4111100000,2020,42010000
F,21820000,19790000,4399000000,2021,41610000
F,21590000,15960000,4146510700,2021,37550000
F,37020000,27690000,4273000000,2024,64710000
F,36310000,19170000,GYEONGGI,2020,55480000
F,8970000,14510000,GANGWON,2024,23480000
M,36180000,28640000,4146510700,2023,64820000
M,28990000,1760000,4146510700,2021,30750000
F,17640000,10820000,GYEONGGI,2021,28460000
F,16150000,19620000,4211000000,2023,35770000
F,9960000,25800000,4291000000,2020,35760000
F,7540000,27560000,4146510700,2021,35100000
F,5380000,5360000,GYEONGGI,2022,10740000
F,12150000,15840000,4291000000,2022,27990000
F,14510000,880000,GYEONGGI,2020,15390000
F,19670000,25630000,GYEONGGI,2023,45300000
M,23060000,15230000,4211000000,2024,38290000
F,48110000,15530000,GYEONGGI,2020,63640000
M,23590000,6220000,4273000000,2024,29810000
F,18980000,13940000,4146510700,2020,32920000
F,39240000,14640000,4111100000,2022,53880000
M,2630000,7850000,4111100000,2023,10480000
F,3130000,29980000,4111100000,2022,33110000
M,27430000,23910000,GYEONGGI,2023,51340000
F,47690000,21660000,4399000000,2024,69350000
F,49570000,3930000,4291000000,2020,53500000
M,24210000,1620000,4291000000,2021,25830000
F,11610000,20150000,GYEONGGI,2021,31760000
M,1720000,27350000,4273000000,2023,29070000
F,46410000,11380000,4273000000,2023,57790000
M,12750000,5980000,4279000000,2022,18730000
M,5070000,24470000,GYEONGGI,2021,29540000
F,32000000,26400000,4280000000,2022,58400000
F,440000,2560000,4211000000,2024,3000000
M,6310000,13450000,4111100000,2021,19760000
F,2270000,26130000,4211000000,2024,28400000
F,41240000,29160000,4111100000,2020,70400000
F,29010000,18070000,GANGWON,2022,47080000
M,23270000,27200000,GANGWON,2023,50470000
M,42890000,24420000,GYEONGGI,2021,67310000
M,15340000,22470000,GANGWON,2022,37810000
M,48750000,26970000,4399000000,2023,75720000
M,34820000,3700000,4279000000,2020,38520000
M,2750000,28930000,4273000000,2021,31680000
M,33090000,9870000,4399000000,2024,42960000
M,1220000,22220000,4211000000,2020,23440000
M,25280000,14310000,4211000000,2023,39590000
F,49840000,16740000,GANGWON,2021,66580000
M,32130000,8010000,4273000000,2021,40140000
F,46450000,4920000,4279000000,2020,51370000
F,41150000,3880000,4111100000,2021,45030000
F,4460000,4010000,4399000000,2023,8470000
M,8800000,29460000,4279000000,2020,38260000
M,22950000,13650000,4146510700,2024,36600000
M,35820000,3300000,4291000000,2020,39120000
M,37960000,13030000,GANGWON,2020,50990000
F,27190000,8720000,4111100000,2024,35910000
M,7640000,24870000,4146510700,2023,32510000
M,19600000,22490000,4111100000,2022,42090000
M,7320000,17430000,4111100000,2022,24750000
M,43390000,1190000,GANGWON,2024,44580000
M,36070000,14530000,4111100000,2023,50600000
F,47000000,23790000,4279000000,2021,70790000
M,42020000,24790000,4279000000,2024,66810000
F,18300000,3320000,4146510700,2022,21620000
M,17600000,6850000,4211000000,2023,24450000
F,16000000,5110000,4273000000,2020,21110000
M,28180000,9140000,4399000000,2023,37320000
M,48440000,380000,4399000000,2023,48820000
F,30280000,9200000,4280000000,2022,39480000
F,370000,960000,GANGWON,2022,1330000
F,18730000,2420000,GYEONGGI,2021,21150000
M,9160000,8200000,GYEONGGI,2021,17360000
F,18540000,7490000,4146510700,2024,26030000
M,14450000,22800000,4111100000,2020,37250000
M,33830000,8990000,4111100000,2021,42820000
F,49300000,10120000,GANGWON,2022,59420000
F,2840000,28590000,4291000000,2023,31430000
M,12120000,25630000,4211000000,2024,37750000
M,7370000,950000,4280000000,2021,8320000
F,25430000,22040000,4279000000,2023,47470000
F,22930000,13650000,4111100000,2023,36580000
F,31850000,13200000,4280000000,2021,45050000
M,35510000,11290000,4399000000,2020,46800000
M,28890000,15790000,4291000000,2020,44680000
M,23000000,4020000,4279000000,2024,27020000
M,22360000,22660000,GANGWON,2020,45020000
M,30780000,23910000,4280000000,2024,54690000
M,17350000,6320000,4146510700,2022,23670000
F,49430000,0,4279000000,2021,49430000
M,4220000,9970000,GANGWON,2023,14190000
M,27640000,20500000,GYEONGGI,2024,48140000
M,41530000,15050000,GANGWON,2020,56580000
F,45140000,1160000,GANGWON,2024,46300000
M,41680000,26580000,4279000000,2024,68260000
M,29750000,20390000,4291000000,2020,50140000
F,47380000,11040000,4279000000,2020,58420000
M,24110000,10220000,4273000000,2021,34330000
M,25690000,27010000,4211000000,2023,52700000
M,20720000,23260000,4291000000,2021,43980000
M,2590000,5790000,4146510700,2021,8380000
M,44910000,17040000,4291000000,2020,61950000
F,28460000,26550000,4399000000,2020,55010000
F,5500000,16390000,4146510700,2023,21890000
F,17290000,2070000,GYEONGGI,2024,19360000
M,20210000,21930000,4279000000,2021,42140000
M,37430000,10580000,GANGWON,2023,48010000
M,28190000,12670000,4279000000,2021,40860000
F,40990000,28210000,4399000000,2024,69200000
M,5890000,26220000,4280000000,2021,32110000
M,30570000,23100000,4399000000,2022,53670000
F,41150000,18170000,4273000000,2023,59320000
M,7940000,16780000,GANGWON,2020,24720000
F,15850000,18740000,GANGWON,2021,34590000
F,10380000,12600000,4111100000,2023,22980000
F,45830000,15920000,4280000000,2023,61750000
M,39240000,14670000,4111100000,2021,53910000
M,47420000,8820000,GYEONGGI,2020,56240000
M,26370000,11570000,4211000000,2020,37940000
M,6700000,19480000,4211000000,2021,26180000
M,18560000,23590000,4279000000,2023,42150000
M,42250000,600000,4211000000,2020,42850000
M,29010000,15580000,GANGWON,2021,44590000
F,530000,26980000,4399000000,2021,27510000
M,20700000,16090000,4280000000,2021,36790000
F,30420000,24150000,4279000000,2023,54570000
M,42130000,15040000,4279000000,2020,57170000
M,8100000,29090000,4280000000,2023,37190000
M,42790000,24140000,GANGWON,2022,66930000
F,38170000,8110000,GYEONGGI,2020,46280000
F,15320000,14360000,GYEONGGI,2023,29680000
F,38880000,7280000,4279000000,2020,46160000
F,29580000,27000000,GYEONGGI,2022,56580000
M,1400000,21870000,GANGWON,2024,23270000
F,23610000,21270000,4273000000,2021,44880000
M,5780000,21080000,4273000000,2023,26860000
M,18000000,4440000,4111100000,2022,22440000
F,22740000,730000,4291000000,2022,23470000
F,16150000,13140000,4146510700,2020,29290000
F,18900000,6480000,4211000000,2020,25380000
F,45190000,17460000,GYEONGGI,2021,62650000
F,49620000,10140000,4273000000,2020,59760000
F,37040000,7550000,4399000000,2023,44590000
F,15860000,26940000,4280000000,2023,42800000
F,40030000,3210000,4291000000,2023,43240000
M,10890000,23640000,4111100000,2024,34530000
F,44470000,2360000,4146510700,2023,46830000
F,17070000,29080000,4273000000,2020,46150000
M,39260000,10840000,4111100000,2020,50100000
F,5430000,13340000,4291000000,2023,18770000
M,21130000,2180000,4280000000,2022,23310000
M,18470000,3710000,4211000000,2022,22180000
F,10390000,3280000,4273000000,2022,13670000
M,16390000,1430000,4280000000,2021,17820000
M,30670000,17340000,4146510700,2024,48010000
M,42060000,18390000,GYEONGGI,2023,60450000
M,12910000,5850000,4291000000,2021,18760000
F,46730000,6840000,4146510700,2022,53570000
M,36200000,27690000,4211000000,2023,63890000
F,31640000,10590000,4280000000,2021,42230000
M,38290000,12160000,GANGWON,2020,50450000
M,43680000,2460000,4211000000,2022,46140000
M,9690000,15840000,4279000000,2021,25530000
M,28560000,24490000,4273000000,2020,53050000
F,30110000,4400000,GYEONGGI,2022,34510000
F,36230000,1410000,4291000000,2024,37640000
M,4300000,20160000,4399000000,2022,24460000
M,40880000,13110000,4280000000,2024,53990000
F,25790000,28410000,GANGWON,2024,54200000
M,8320000,5060000,4399000000,2024,13380000
M,30370000,7710000,4273000000,2023,38080000
M,8830000,6850000,4273000000,2023,15680000
F,39720000,28570000,4291000000,2024,68290000
F,3450000,10070000,GANGWON,2020,13520000
F,1880000,11460000,4273000000,2024,13340000
M,45180000,15310000,4399000000,2021,60490000
M,30910000,19390000,GANGWON,2024,50300000
F,37510000,1930000,4399000000,2023,39440000
F,35310000,23170000,4211000000,2023,58480000
F,44180000,21340000,4146510700,2021,65520000
F,43560000,2420000,GANGWON,2021,45980000
M,4050000,15390000,4111100000,2022,19440000
F,800000,15160000,4146510700,2020,15960000
M,6930000,19990000,4146510700,2020,26920000
F,41040000,24170000,GANGWON,2020,65210000
M,19330000,1860000,GYEONGGI,2023,21190000
F,31060000,5360000,4273000000,2020,36420000
F,34270000,15370000,4211000000,2022,49640000
F,22280000,9440000,GYEONGGI,2022,31720000
F,28390000,28070000,GYEONGGI,2020,56460000
M,16530000,40000,4111100000,2021,16570000
F,23190000,28620000,4280000000,2022,51810000
M,27960000,5160000,GANGWON,2021,33120000
M,34570000,12160000,4399000000,2023,46730000
M,23530000,19040000,4273000000,2022,42570000
M,5770000,18870000,GYEONGGI,2021,24640000
F,44320000,8500000,4211000000,2020,52820000
M,2890000,290000,4280000000,2023,3180000
M,10200000,19300000,4111100000,2024,29500000
M,46270000,11660000,4279000000,2024,57930000
F,23740000,5620000,4273000000,2020,29360000
F,49600000,8090000,4279000000,2023,57690000
F,10530000,21730000,4146510700,2023,32260000
F,19590000,17700000,GYEONGGI,2023,37290000
M,47100000,5900000,4291000000,2023,53000000
M,17290000,29220000,4273000000,2024,46510000
F,19410000,13350000,4399000000,2021,32760000
M,17010000,6500000,4280000000,2023,23510000
M,34490000,12980000,4211000000,2021,47470000
M,48680000,8140000,4273000000,2023,56820000
F,10220000,9320000,4399000000,2022,19540000
F,41590000,14040000,GANGWON,2022,55630000
M,34020000,2460000,4279000000,2022,36480000
F,33820000,3290000,GANGWON,2023,37110000
F,13900000,11360000,4280000000,2021,25260000
F,5450000,13430000,4111100000,2024,18880000
F,6120000,6430000,GYEONGGI,2020,12550000
F,1160000,15820000,4273000000,2024,16980000
M,43330000,7420000,4291000000,2023,50750000
F,13760000,4130000,4279000000,2022,17890000
M,2400000,24300000,4279000000,2022,26700000
M,46690000,1240000,4273000000,2021,47930000
F,40580000,10980000,4146510700,2023,51560000
M,25080000,17450000,GANGWON,2024,42530000
M,11950000,16170000,4279000000,2023,28120000
M,32290000,2020000,4399000000,2023,34310000
F,20060000,13840000,4211000000,2022,33900000
F,70000,2090000,GYEONGGI,2024,2160000
M,11070000,7160000,4279000000,2020,18230000
F,18850000,3740000,4399000000,2022,22590000
F,19780000,29450000,4280000000,2024,49230000
F,1550000,17320000,4280000000,2021,18870000
F,32640000,17960000,GYEONGGI,2022,50600000
M,13070000,26270000,4146510700,2021,39340000
M,49370000,8200000,4291000000,2022,57570000
F,37870000,8430000,GYEONGGI,2023,46300000
F,21720000,10930000,4111100000,2024,32650000
M,5440000,23500000,4146510700,2021,28940000
M,8550000,15460000,4279000000,2022,24010000
F,9610000,8980000,GYEONGGI,2021,18590000
M,36560000,4520000,GANGWON,2022,41080000
F,9710000,28070000,4280000000,2022,37780000
F,49620000,1880000,4399000000,2020,51500000
M,9800000,4370000,GYEONGGI,2020,14170000
M,7200000,27610000,GANGWON,2020,34810000
F,19980000,4860000,4146510700,2021,24840000
F,5050000,17150000,4111100000,2023,22200000
M,3620000,29360000,4399000000,2022,32980000
F,280000,10540000,4211000000,2024,10820000
M,22050000,27600000,4111100000,2020,49650000
F,43060000,28080000,4279000000,2021,71140000
M,17350000,16880000,GANGWON,2021,34230000
M,14680000,4730000,GYEONGGI,2021,19410000
M,31380000,21090000,GYEONGGI,2024,52470000
F,20100000,16410000,4273000000,2024,36510000
F,9240000,21630000,4280000000,2020,30870000
M,47510000,19650000,4279000000,2024,67160000
F,33970000,22220000,GANGWON,2020,56190000
M,46590000,25970000,GYEONGGI,2024,72560000
M,24990000,28540000,4211000000,2024,53530000
F,11050000,14440000,4399000000,2024,25490000
F,4900000,26020000,4279000000,2020,30920000
M,9900000,12840000,4146510700,2022,22740000
F,13950000,29640000,4211000000,2020,43590000
F,6330000,17970000,4399000000,2022,24300000
M,22450000,9070000,4291000000,2021,31520000
M,17170000,23380000,4280000000,2021,40550000
F,23870000,410000,4279000000,2020,24280000
M,13700000,21020000,GANGWON,2022,34720000
M,460000,14770000,4111100000,2022,15230000
F,41290000,11460000,4399000000,2022,52750000
M,14500000,16140000,4146510700,2021,30640000
M,5990000,25100000,GYEONGGI,2020,31090000
F,39410000,26930000,4111100000,2023,66340000
F,4980000,7150000,4211000000,2022,12130000
M,9390000,4800000,4280000000,2022,14190000
M,17080000,12140000,GANGWON,2023,29220000
F,11590000,14210000,4111100000,2020,25800000
F,39820000,6930000,4146510700,2022,46750000
F,40870000,620000,4399000000,2020,41490000
F,7820000,9900000,GANGWON,2022,17720000
M,29850000,9300000,4291000000,2024,39150000
F,36730000,19700000,GYEONGGI,2022,56430000
F,17530000,10420000,4280000000,2024,27950000
M,19090000,24150000,4111100000,2020,43240000
F,19010000,25560000,4280000000,2022,44570000
M,48560000,21020000,4280000000,2021,69580000
F,35450000,8630000,4280000000,2021,44080000
F,35100000,23750000,4399000000,2023,58850000
F,8150000,12390000,4280000000,2021,20540000
M,36820000,16480000,4291000000,2024,53300000
M,25250000,28990000,4211000000,2021,54240000
F,45560000,8620000,4146510700,2021,54180000
M,27090000,15250000,GANGWON,2021,42340000
M,33260000,21480000,4291000000,2022,54740000
M,32430000,15800000,GANGWON,2023,48230000
M,13130000,3600000,4146510700,2020,16730000
M,19540000,25310000,4211000000,2023,44850000
M,28740000,11720000,4279000000,2024,40460000
F,44980000,6630000,GANGWON,2022,51610000
F,40850000,17600000,GANGWON,2022,58450000
M,23620000,24230000,4211000000,2021,47850000
F,14130000,1780000,4111100000,2021,15910000
F,8650000,23350000,4291000000,2024,32000000
F,49810000,7370000,4111100000,2022,57180000
F,25520000,5030000,4111100000,2020,30550000
M,29630000,22090000,4111100000,2023,51720000
F,17810000,12920000,4280000000,2022,30730000
F,39590000,8130000,GYEONGGI,2020,47720000
M,26910000,16810000,GANGWON,2020,43720000
M,14310000,26600000,4111100000,2023,40910000
F,39100000,16910000,4291000000,2020,56010000
F,3100000,2630000,GYEONGGI,2024,5730000
F,36210000,5410000,GYEONGGI,2020,41620000
F,3670000,20070000,4111100000,2024,23740000
F,18860000,12180000,4399000000,2020,31040000
F,12540000,370000,4111100000,2021,12910000
M,10640000,13560000,4399000000,2020,24200000
F,36570000,14160000,4111100000,2024,50730000
F,16070000,28700000,4291000000,2020,44770000
M,44330000,27720000,4399000000,2020,72050000
M,4850000,10120000,4280000000,2020,14970000
M,19240000,18730000,GYEONGGI,2024,37970000
M,48050000,5020000,4111100000,2020,53070000
F,3830000,25380000,GYEONGGI,2023,29210000
F,11950000,27320000,4111100000,2023,39270000
F,13830000,17200000,GANGWON,2024,31030000
F,18130000,20270000,GANGWON,2021,38400000
F,36920000,20660000,4273000000,2023,57580000
F,4260000,16660000,4111100000,2022,20920000
M,6030000,5980000,4273000000,2023,12010000
F,42810000,20920000,4211000000,2022,63730000
M,23780000,9540000,4211000000,2024,33320000
M,16610000,14990000,GYEONGGI,2021,31600000
F,4070000,25860000,4399000000,2022,29930000
M,24720000,14090000,4111100000,2022,38810000
F,23640000,23760000,4146510700,2023,47400000
M,44600000,1760000,4111100000,2022,46360000
F,32910000,8610000,4111100000,2024,41520000
M,11260000,5530000,4146510700,2024,16790000
F,1360000,11320000,4211000000,2024,12680000
F,22290000,19010000,4273000000,2023,41300000
F,23490000,2760000,GYEONGGI,2021,26250000
F,740000,18840000,4211000000,2023,19580000
F,15710000,18890000,4146510700,2024,34600000
M,46100000,14760000,4111100000,2023,60860000
M,41770000,20000,4211000000,2024,41790000
M,24520000,8070000,4291000000,2020,32590000
F,4460000,19980000,GANGWON,2020,24440000
M,41010000,21630000,4111100000,2022,62640000
F,26500000,22740000,4279000000,2021,49240000
F,42420000,29100000,4146510700,2020,71520000
M,27440000,14020000,4280000000,2024,41460000
M,17960000,23270000,4399000000,2023,41230000
F,38510000,8660000,4280000000,2023,47170000
M,14220000,8290000,4211000000,2022,22510000
F,33030000,16020000,4111100000,2023,49050000
F,24500000,28910000,4399000000,2020,53410000
F,19170000,23420000,4399000000,2023,42590000
F,1500000,1610000,GYEONGGI,2020,3110000
F,6320000,28490000,4280000000,2020,34810000
M,20880000,14890000,4111100000,2021,35770000
M,31830000,4030000,GYEONGGI,2022,35860000
F,39390000,11520000,4273000000,2024,50910000
F,15220000,12230000,4280000000,2020,27450000
M,36250000,1350000,GANGWON,2022,37600000
M,27870000,27570000,GANGWON,2024,55440000
F,32430000,14730000,GYEONGGI,2023,47160000
M,39110000,25930000,4273000000,2022,65040000
F,38450000,23540000,4291000000,2022,61990000
M,16960000,21870000,4291000000,2022,38830000
F,47710000,19590000,GANGWON,2023,67300000
M,20490000,27200000,4279000000,2023,47690000
F,31170000,450000,4146510700,2022,31620000
M,5840000,17980000,4146510700,2021,23820000
M,46840000,22130000,4279000000,2020,68970000
F,35100000,17220000,GYEONGGI,2023,52320000
M,11730000,16220000,4146510700,2021,27950000
F,48490000,22460000,4146510700,2023,70950000
M,8310000,3920000,4280000000,2022,12230000
F,3900000,27270000,4280000000,2021,31170000
M,37350000,11990000,4279000000,2024,49340000
F,11350000,5000000,4111100000,2020,16350000
M,6720000,6920000,4273000000,2020,13640000
F,15050000,18830000,GYEONGGI,2023,33880000
M,48960000,17840000,4280000000,2020,66800000
F,9030000,4730000,4280000000,2024,13760000
F,18290000,9330000,4291000000,2021,27620000
F,32670000,4230000,4273000000,2021,36900000
M,6280000,6070000,4291000000,2022,12350000
F,39980000,11460000,4111100000,2021,51440000
M,43140000,26890000,4273000000,2023,70030000
F,28750000,13560000,4146510700,2024,42310000
M,21950000,12260000,4291000000,2022,34210000
F,38830000,29580000,GANGWON,2023,68410000
M,37960000,4050000,GYEONGGI,2023,42010000
M,14940000,29660000,4146510700,2023,44600000
F,13360000,860000,4273000000,2020,14220000
M,27550000,27740000,GANGWON,2023,55290000
M,41560000,3090000,4111100000,2020,44650000
F,11040000,27480000,GANGWON,2021,38520000
M,11630000,710000,4280000000,2020,12340000
M,5050000,23770000,4279000000,2023,28820000
M,41640000,20970000,GANGWON,2024,62610000
F,36540000,13580000,4399000000,2024,50120000
M,8820000,23860000,4111100000,2021,32680000
F,36850000,16250000,4146510700,2023,53100000
M,47330000,16290000,4291000000,2020,63620000
M,18140000,20210000,4211000000,2024,38350000
M,27590000,23200000,4111100000,2022,50790000
F,23490000,6670000,4399000000,2023,30160000
M,29180000,5210000,4280000000,2023,34390000
M,25010000,27920000,4291000000,2022,52930000
F,10930000,750000,GYEONGGI,2024,11680000
M,21220000,20130000,4211000000,2022,41350000
F,43510000,23850000,GANGWON,2021,67360000
F,9240000,17700000,4399000000,2020,26940000
M,47650000,17130000,GANGWON,2020,64780000
F,30220000,28600000,GYEONGGI,2024,58820000
M,27320000,18160000,4111100000,2022,45480000
F,13730000,13960000,4279000000,2023,27690000
F,22430000,20290000,4399000000,2023,42720000
M,48030000,24490000,4273000000,2023,72520000
F,28370000,110000,4146510700,2021,28480000
F,16930000,220000,4273000000,2021,17150000
F,3830000,25510000,4279000000,2023,29340000
F,11670000,21750000,GYEONGGI,2024,33420000
F,29580000,29080000,4273000000,2021,58660000
M,6490000,28090000,4280000000,2021,34580000
F,32260000,9420000,4399000000,2020,41680000
M,31700000,28310000,4280000000,2020,60010000
F,680000,26490000,4211000000,2024,27170000
M,5330000,13930000,4279000000,2021,19260000
M,48760000,20430000,4211000000,2021,69190000
F,6980000,15300000,4211000000,2022,22280000
F,26910000,23670000,4211000000,2024,50580000
F,37550000,12930000,4111100000,2024,50480000
M,16680000,18190000,4111100000,2022,34870000
F,47870000,20120000,4279000000,2022,67990000
M,44760000,3470000,4291000000,2020,48230000
M,18130000,12820000,4273000000,2024,30950000
M,20970000,24880000,4111100000,2024,45850000
F,7960000,17460000,GANGWON,2022,25420000
F,21440000,16610000,4280000000,2023,38050000
M,34750000,10570000,4111100000,2023,45320000
M,34600000,9430000,GYEONGGI,2020,44030000
F,4680000,26360000,4211000000,2023,31040000
M,41900000,14430000,4111100000,2023,56330000
F,48460000,19450000,4279000000,2023,67910000
M,40530000,16310000,4280000000,2021,56840000
F,10160000,2990000,4280000000,2020,13150000
M,33220000,9140000,4291000000,2022,42360000
F,38300000,2930000,4146510700,2023,41230000
M,32330000,2830000,4146510700,2021,35160000
F,6460000,6170000,4273000000,2023,12630000
F,39680000,23590000,GANGWON,2021,63270000
M,42610000,14940000,4399000000,2020,57550000
M,4900000,17590000,4279000000,2023,22490000
F,44600000,8240000,GYEONGGI,2021,52840000
M,40160000,10780000,4111100000,2024,50940000
F,39120000,5040000,4279000000,2024,44160000
M,22000000,22430000,GANGWON,2021,44430000
F,27340000,3470000,4146510700,2023,30810000
F,17490000,10530000,4279000000,2023,28020000
F,45850000,10450000,4111100000,2020,56300000
F,31450000,25030000,4291000000,2020,56480000
F,10560000,7530000,4273000000,2022,18090000
F,10080000,2540000,4291000000,2020,12620000
M,3880000,21720000,4146510700,2023,25600000
M,43750000,5190000,4211000000,2022,48940000
M,45570000,27360000,4146510700,2020,72930000
F,40270000,28870000,4273000000,2021,69140000
F,37170000,12300000,4111100000,2024,49470000
F,21970000,18760000,GANGWON,2020,40730000
F,8450000,24510000,4399000000,2020,32960000
M,9130000,6780000,4291000000,2021,15910000
M,39270000,2120000,4146510700,2023,41390000
F,42180000,3770000,GANGWON,2021,45950000
M,6930000,2050000,4291000000,2020,8980000
M,22320000,23060000,4146510700,2023,45380000
F,16790000,17820000,4273000000,2022,34610000
M,28820000,29100000,4291000000,2020,57920000
F,46700000,4680000,4146510700,2021,51380000
M,39560000,4170000,4111100000,2022,43730000
F,44960000,25560000,4273000000,2024,70520000
F,14510000,5700000,GANGWON,2022,20210000
F,9610000,17670000,GANGWON,2021,27280000
F,32250000,12140000,4399000000,2022,44390000
M,22520000,25340000,4279000000,2021,47860000
F,14550000,29560000,4211000000,2020,44110000
F,22410000,5240000,4111100000,2023,27650000
F,9000000,24530000,4273000000,2024,33530000
M,15720000,8230000,4291000000,2023,23950000
F,3760000,11260000,GANGWON,2023,15020000
M,49430000,29340000,4111100000,2023,78770000
F,3320000,11660000,4273000000,2021,14980000
M,47710000,9410000,4273000000,2021,57120000
M,14060000,18470000,4291000000,2024,32530000
F,5210000,20340000,4273000000,2021,25550000
M,41810000,3600000,GYEONGGI,2021,45410000
F,37370000,20000,4111100000,2021,37390000
F,23420000,4590000,4146510700,2021,28010000
F,2840000,19580000,GANGWON,2020,22420000
M,46780000,4580000,GANGWON,2024,51360000
M,46330000,29720000,4146510700,2021,76050000
F,39540000,3120000,4111100000,2024,42660000
F,23840000,18150000,4211000000,2022,41990000
M,33260000,18890000,4111100000,2020,52150000
F,24640000,10230000,4280000000,2021,34870000
F,16150000,24820000,4273000000,2020,40970000
F,33930000,17590000,4279000000,2020,51520000
M,16210000,19420000,4291000000,2022,35630000
M,20650000,1110000,GYEONGGI,2024,21760000
M,33180000,11260000,4279000000,2020,44440000
F,3030000,12180000,4146510700,2023,15210000
F,26680000,26590000,4291000000,2022,53270000
F,27640000,5700000,4291000000,2023,33340000
M,23180000,3890000,4291000000,2022,27070000
F,14930000,28480000,GANGWON,2023,43410000
F,34330000,23230000,GYEONGGI,2023,57560000
F,21680000,7040000,GANGWON,2020,28720000
F,40620000,22410000,4273000000,2020,63030000
M,31590000,26620000,4280000000,2022,58210000
M,29050000,27130000,4399000000,2024,56180000
F,47330000,15280000,GYEONGGI,2020,62610000
M,11990000,15830000,4279000000,2020,27820000
M,6290000,6220000,4273000000,2021,12510000
F,22570000,9630000,4111100000,2020,32200000
F,28460000,2780000,4146510700,2024,31240000
M,39480000,2090000,4280000000,2021,41570000
F,45020000,26150000,4273000000,2023,71170000
M,43270000,4210000,4111100000,2023,47480000
F,30730000,29380000,4280000000,2021,60110000
M,34400000,11770000,4111100000,2021,46170000
F,47060000,28160000,GYEONGGI,2021,75220000
M,45140000,28710000,4111100000,2022,73850000
M,8550000,8830000,4280000000,2024,17380000
M,33980000,19060000,4111100000,2024,53040000
F,43620000,930000,4279000000,2023,44550000
M,48780000,14240000,4273000000,2023,63020000
M,39200000,1840000,4280000000,2023,41040000
F,29360000,14960000,4279000000,2020,44320000
F,4320000,17320000,4111100000,2023,21640000
M,44900000,13960000,4111100000,2021,58860000
M,23720000,13650000,4291000000,2023,37370000
F,44770000,11930000,4280000000,2021,56700000
F,12630000,3300000,GYEONGGI,2022,15930000
F,23440000,21560000,4111100000,2020,45000000
F,40090000,10180000,4146510700,2020,50270000
F,25290000,28470000,GANGWON,2024,53760000
M,30590000,25530000,4399000000,2022,56120000
F,22740000,11840000,GANGWON,2021,34580000
M,46260000,2050000,GYEONGGI,2022,48310000
M,31980000,23460000,4273000000,2020,55440000
M,23670000,13370000,4211000000,2021,37040000
F,19850000,25850000,4146510700,2022,45700000
M,2840000,15020000,4211000000,2020,17860000
M,11010000,1650000,4111100000,2021,12660000
F,46530000,2790000,4273000000,2021,49320000
M,15140000,27800000,4279000000,2020,42940000
M,38620000,8030000,4111100000,2021,46650000
F,10060000,17990000,4211000000,2020,28050000
M,20870000,11960000,4111100000,2023,32830000
M,28100000,25510000,4399000000,2023,53610000
M,42500000,27190000,4291000000,2021,69690000
F,5300000,27000000,4399000000,2021,32300000
F,18280000,2600000,4273000000,2020,20880000
F,19420000,2760000,4279000000,2021,22180000
M,17970000,18450000,4399000000,2024,36420000
M,47900000,3780000,4280000000,2023,51680000
F,4880000,15940000,4279000000,2021,20820000
M,40680000,5700000,4211000000,2021,46380000
M,870000,10240000,4399000000,2022,11110000
F,22820000,20660000,4291000000,2021,43480000
F,15520000,430000,4279000000,2024,15950000
M,29530000,9590000,4111100000,2023,39120000
M,48410000,19110000,4291000000,2022,67520000
M,48470000,29780000,4111100000,2020,78250000
F,35730000,28500000,4399000000,2020,64230000
F,19380000,7510000,4146510700,2023,26890000
F,31600000,19680000,4146510700,2020,51280000
F,35250000,650000,4211000000,2024,35900000
M,37820000,19740000,4291000000,2021,57560000
F,29180000,15860000,4111100000,2023,45040000
F,33320000,6590000,GYEONGGI,2022,39910000
F,2970000,8230000,4291000000,2021,11200000
F,38650000,23380000,4280000000,2020,62030000
F,31660000,20880000,4211000000,2020,52540000
M,46830000,22990000,GANGWON,2022,69820000
M,13760000,21090000,GANGWON,2024,34850000
F,23060000,13400000,4111100000,2022,36460000
M,14570000,12850000,4146510700,2023,27420000
F,41700000,19830000,4279000000,2022,61530000
F,9170000,27890000,4280000000,2020,37060000
M,22940000,22830000,GANGWON,2024,45770000
M,45500000,8680000,4111100000,2024,54180000
F,28910000,12330000,4111100000,2022,41240000
F,24270000,22380000,4399000000,2023,46650000
F,49320000,16610000,4146510700,2020,65930000
M,39770000,25200000,4291000000,2021,64970000
F,10510000,13220000,4279000000,2024,23730000
F,46660000,25930000,4399000000,2022,72590000
F,38140000,300000,GANGWON,2023,38440000
M,43560000,3370000,4279000000,2023,46930000
F,8970000,1390000,4211000000,2020,10360000
F,13790000,26150000,4146510700,2024,39940000
M,28090000,2760000,GANGWON,2020,30850000
F,3680000,1710000,4111100000,2021,5390000
F,35090000,26960000,GANGWON,2021,62050000
M,49870000,1040000,GYEONGGI,2021,50910000
F,41010000,3820000,4273000000,2023,44830000
M,19840000,19730000,4273000000,2024,39570000
M,17920000,29260000,GANGWON,2020,47180000
F,32450000,11320000,GYEONGGI,2020,43770000
F,45550000,3690000,GANGWON,2021,49240000
F,23930000,16170000,4273000000,2024,40100000
F,1410000,6110000,4399000000,2024,7520000
M,30250000,10500000,4211000000,2022,40750000
F,19470000,2550000,4273000000,2024,22020000
M,29280000,22970000,4211000000,2024,52250000
F,420000,18470000,4111100000,2020,18890000
F,900000,27690000,4211000000,2024,28590000
F,15990000,13020000,4399000000,2024,29010000
M,49560000,130000,GYEONGGI,2020,49690000
F,48420000,21730000,4211000000,2024,70150000
F,34140000,8570000,4279000000,2020,42710000
F,12420000,20590000,4291000000,2022,33010000
F,29920000,24670000,4273000000,2023,54590000
M,26630000,24920000,GYEONGGI,2020,51550000
F,16430000,4170000,4280000000,2020,20600000
M,12250000,4620000,4111100000,2024,16870000
M,5730000,22920000,4291000000,2020,28650000
M,25580000,5880000,4279000000,2021,31460000
M,35930000,5680000,4146510700,2021,41610000
M,47360000,9190000,4399000000,2022,56550000
M,41720000,24460000,GANGWON,2020,66180000
F,12550000,4300000,4291000000,2024,16850000
M,33210000,14380000,GYEONGGI,2024,47590000
M,43860000,23850000,GYEONGGI,2023,67710000
M,13600000,6800000,GYEONGGI,2022,20400000
F,7080000,16990000,4111100000,2024,24070000
F,13820000,19030000,4211000000,2023,32850000
M,6690000,24780000,4273000000,2024,31470000
F,10580000,23560000,4146510700,2023,34140000
M,25800000,10840000,GANGWON,2021,36640000
M,36350000,4210000,GYEONGGI,2021,40560000
F,25970000,23420000,GANGWON,2024,49390000
M,46460000,26420000,4280000000,2022,72880000
F,44800000,2870000,4111100000,2020,47670000
F,11950000,24460000,GYEONGGI,2022,36410000
M,6830000,23790000,4280000000,2022,30620000
M,8570000,8120000,4146510700,2020,16690000
F,19360000,11880000,4146510700,2021,31240000
M,14990000,21790000,4273000000,2021,36780000
M,34760000,6600000,4279000000,2020,41360000
M,31700000,16850000,4273000000,2023,48550000
F,950000,5400000,4211000000,2022,6350000
F,16990000,160000,GANGWON,2024,17150000
M,21610000,28130000,4399000000,2021,49740000
F,49820000,1930000,4146510700,2024,51750000
F,40520000,4240000,4399000000,2020,44760000
F,32400000,2300000,4111100000,2024,34700000
F,10820000,5920000,4291000000,2024,16740000
F,16510000,20990000,GYEONGGI,2022,37500000
M,31340000,6730000,4111100000,2020,38070000
M,32470000,2080000,4146510700,2024,34550000
M,22680000,19450000,4280000000,2021,42130000
F,32550000,3450000,GANGWON,2020,36000000
F,18560000,29760000,4399000000,2021,48320000
M,38060000,7600000,4273000000,2023,45660000
F,26500000,25030000,4291000000,2024,51530000
M,21240000,1730000,4279000000,2020,22970000
M,44120000,5350000,4111100000,2021,49470000
M,1470000,11800000,4279000000,2024,13270000
F,9950000,6770000,4399000000,2022,16720000
F,15000000,8530000,4399000000,2021,23530000
M,25850000,5550000,GYEONGGI,2021,31400000
M,33950000,7080000,4280000000,2023,41030000
M,26200000,6820000,4280000000,2022,33020000
M,28040000,11760000,4211000000,2023,39800000
F,9550000,14710000,4273000000,2022,24260000
F,24330000,14880000,4146510700,2021,39210000
M,14720000,12360000,4146510700,2023,27080000
M,14160000,22980000,4399000000,2024,37140000
F,40480000,9050000,4111100000,2022,49530000
F,9830000,4790000,GANGWON,2021,14620000
M,2100000,17030000,4146510700,2020,19130000
M,40470000,15440000,4146510700,2022,55910000
M,9320000,17140000,4111100000,2022,26460000
F,18160000,3100000,4273000000,2024,21260000
F,45750000,22170000,4291000000,2022,67920000
F,45010000,710000,4280000000,2022,45720000
M,36400000,18650000,GYEONGGI,2024,55050000
M,13970000,20770000,GYEONGGI,2024,34740000
F,18890000,26150000,GYEONGGI,2023,45040000
F,5550000,1050000,4111100000,2021,6600000
M,3670000,19130000,GYEONGGI,2021,22800000
F,38110000,3480000,4399000000,2023,41590000
F,15070000,2080000,4211000000,2021,17150000
M,39780000,27130000,4111100000,2022,66910000
F,21770000,25440000,4111100000,2023,47210000
M,9680000,27000000,4280000000,2023,36680000
M,6970000,15950000,GYEONGGI,2021,22920000
M,30450000,21490000,4279000000,2020,51940000
M,48790000,5240000,4291000000,2021,54030000
M,43750000,27840000,4211000000,2020,71590000
M,44050000,11060000,4111100000,2023,55110000
M,42160000,24440000,4211000000,2020,66600000
F,26150000,11110000,4111100000,2022,37260000
M,8540000,16900000,4273000000,2024,25440000
M,30880000,19420000,4280000000,2020,50300000
F,29850000,4860000,4399000000,2024,34710000
F,41090000,17570000,4273000000,2022,58660000
F,11550000,2050000,GANGWON,2024,13600000
M,42400000,18710000,GYEONGGI,2022,61110000
F,15270000,27570000,GANGWON,2024,42840000
M,2680000,27700000,4291000000,2024,30380000
M,33740000,24960000,4279000000,2021,58700000
M,17010000,23220000,4399000000,2020,40230000
M,40840000,25390000,4273000000,2024,66230000
F,14390000,2070000,4211000000,2023,16460000
F,19630000,28810000,4211000000,2021,48440000
M,44670000,5460000,4291000000,2020,50130000
M,30000000,14270000,4111100000,2021,44270000
M,45540000,25150000,4211000000,2020,70690000
F,34300000,21320000,GYEONGGI,2022,55620000
M,17290000,10860000,4279000000,2024,28150000
M,45870000,22880000,4280000000,2023,68750000
F,28380000,1200000,GYEONGGI,2021,29580000
F,48380000,15110000,4279000000,2021,63490000
M,31580000,25650000,4291000000,2021,57230000
F,2330000,12370000,GYEONGGI,2021,14700000
F,27490000,22990000,4280000000,2024,50480000
M,38630000,29130000,4280000000,2020,67760000
F,22040000,1760000,4146510700,2024,23800000
M,33010000,25460000,4111100000,2022,58470000
F,31260000,14750000,4291000000,2024,46010000
M,9040000,6130000,GYEONGGI,2024,15170000
M,2250000,15590000,4399000000,2022,17840000
M,43940000,11470000,4399000000,2024,55410000
F,10390000,12520000,4291000000,2020,22910000
M,41840000,16670000,GYEONGGI,2023,58510000
F,49400000,23120000,4273000000,2022,72520000
M,42390000,23210000,4273000000,2021,65600000
M,30890000,13660000,4111100000,2020,44550000
F,41280000,4140000,GYEONGGI,2023,45420000
M,1470000,2200000,4280000000,2020,3670000
M,4470000,17840000,4211000000,2020,22310000
F,13240000,21190000,4399000000,2021,34430000
M,32460000,10420000,GYEONGGI,2023,42880000
M,3520000,26400000,GYEONGGI,2020,29920000
M,33240000,3300000,4211000000,2021,36540000
M,38360000,23040000,4211000000,2022,61400000
F,33420000,19730000,4279000000,2021,53150000
F,39830000,29970000,4146510700,2024,69800000
M,46130000,7490000,4111100000,2021,53620000
F,45750000,22160000,4399000000,2021,67910000
M,32450000,17170000,4211000000,2021,49620000
F,43150000,6180000,4273000000,2020,49330000
M,46500000,15280000,4291000000,2023,61780000
M,1190000,3790000,4273000000,2021,4980000
M,43090000,1730000,4279000000,2021,44820000
M,27140000,24510000,4279000000,2024,51650000
M,30420000,6110000,4211000000,2024,36530000
M,37450000,16460000,4279000000,2022,53910000
F,24160000,16070000,4280000000,2022,40230000
M,3380000,20360000,GANGWON,2024,23740000
F,19520000,2410000,GYEONGGI,2023,21930000
M,45430000,17300000,GYEONGGI,2022,62730000
F,9660000,23530000,4211000000,2023,33190000
F,45270000,2920000,4279000000,2024,48190000
F,41750000,29070000,4291000000,2022,70820000
M,8180000,9140000,4280000000,2021,17320000
M,24840000,15040000,4111100000,2024,39880000
F,46470000,17380000,4279000000,2022,63850000
M,10190000,18110000,4280000000,2023,28300000
F,12980000,23600000,4146510700,2023,36580000
M,30030000,10590000,4111100000,2022,40620000
F,37910000,7680000,GYEONGGI,2023,45590000
F,48430000,22890000,4146510700,2022,71320000
M,19570000,7200000,4211000000,2022,26770000
F,12760000,5150000,4399000000,2023,17910000
M,32020000,4820000,4211000000,2020,36840000
F,25430000,5210000,4291000000,2021,30640000
F,21840000,17910000,4280000000,2024,39750000
M,38640000,24130000,4399000000,2021,62770000
M,570000,5560000,4111100000,2024,6130000
M,6610000,2950000,4111100000,2024,9560000
F,47790000,18940000,4146510700,2021,66730000
M,7580000,290000,4291000000,2022,7870000
F,45280000,6500000,GYEONGGI,2023,51780000
F,16540000,1550000,4279000000,2020,18090000
M,21910000,6130000,4279000000,2020,28040000
M,810000,27420000,4399000000,2020,28230000
F,22080000,19150000,4291000000,2021,41230000
F,48160000,9240000,4291000000,2021,57400000
M,16400000,500000,4111100000,2022,16900000
M,12660000,28940000,GYEONGGI,2020,41600000
M,28040000,12350000,4280000000,2022,40390000
M,19710000,230000,GYEONGGI,2020,19940000
M,16190000,28820000,4273000000,2021,45010000
F,38700000,9450000,4291000000,2023,48150000
F,34970000,19920000,4211000000,2023,54890000
F,3680000,21320000,GANGWON,2023,25000000
F,21170000,16630000,4291000000,2023,37800000
M,20470000,20800000,4399000000,2024,41270000
M,10670000,10070000,4211000000,2020,20740000
M,30800000,29000000,4399000000,2023,59800000
F,3640000,4160000,4146510700,2024,7800000
F,39980000,27890000,GANGWON,2024,67870000
M,32990000,10190000,GANGWON,2024,43180000
M,4070000,15070000,4111100000,2022,19140000
F,5350000,90000,4291000000,2022,5440000
F,23550000,22110000,4111100000,2024,45660000
M,2180000,25370000,4279000000,2023,27550000
M,15860000,2360000,4399000000,2020,18220000
F,9930000,26590000,4273000000,2021,36520000
M,9950000,13440000,4273000000,2022,23390000
M,47040000,20840000,4279000000,2023,67880000
M,14020000,28550000,4146510700,2023,42570000
F,47950000,2280000,4273000000,2021,50230000
F,28550000,1530000,4399000000,2021,30080000
F,47420000,780000,4273000000,2023,48200000
F,40540000,11290000,4279000000,2021,51830000
F,9140000,7590000,4211000000,2023,16730000
F,35630000,10450000,4111100000,2021,46080000
F,33120000,16190000,4280000000,2021,49310000
M,2140000,16420000,4399000000,2023,18560000
M,3140000,13110000,4111100000,2024,16250000
M,17060000,770000,GANGWON,2023,17830000
M,18740000,23870000,GYEONGGI,2020,42610000
M,45960000,9300000,4273000000,2021,55260000
M,18170000,16990000,4273000000,2022,35160000
M,42610000,13890000,4146510700,2021,56500000
F,2190000,4510000,4111100000,2020,6700000
F,43530000,6630000,GYEONGGI,2022,50160000
M,46950000,3520000,4273000000,2022,50470000
M,47400000,11610000,GANGWON,2023,59010000
F,19750000,26610000,4146510700,2024,46360000
M,18180000,22250000,4111100000,2023,40430000
M,27840000,29650000,4146510700,2022,57490000
F,5050000,6570000,4111100000,2022,11620000
M,14350000,9280000,4291000000,2024,23630000
F,49880000,14190000,4291000000,2021,64070000
M,28580000,4440000,4279000000,2024,33020000
F,2460000,17420000,4399000000,2023,19880000
F,40110000,12910000,4146510700,2021,53020000
F,15130000,2900000,4279000000,2023,18030000
M,5630000,28330000,4146510700,2024,33960000
F,47490000,22640000,4273000000,2021,70130000
M,2900000,24840000,4280000000,2024,27740000
M,15780000,4560000,4146510700,2020,20340000
M,43460000,19240000,4273000000,2022,62700000
M,1720000,19910000,GYEONGGI,2021,21630000
F,27680000,27540000,4291000000,2022,55220000
F,46610000,18420000,4279000000,2020,65030000
M,30990000,18120000,4280000000,2021,49110000
M,19640000,26020000,GANGWON,2022,45660000
F,6880000,21870000,4291000000,2022,28750000
M,24720000,2230000,4279000000,2021,26950000
F,40470000,580000,4280000000,2022,41050000
M,40080000,4560000,GANGWON,2022,44640000
M,22140000,1420000,4211000000,2021,23560000
F,44830000,10600000,4273000000,2022,55430000
M,12370000,25880000,4211000000,2022,38250000
F,23530000,28660000,4273000000,2023,52190000
M,8340000,28670000,4111100000,2023,37010000
M,44040000,8350000,4399000000,2020,52390000
M,22300000,22640000,4280000000,2023,44940000
F,41570000,15800000,4211000000,2023,57370000
M,41000000,25510000,4399000000,2020,66510000
M,28330000,27160000,4280000000,2022,55490000
M,3880000,1480000,4279000000,2022,5360000
M,38090000,16940000,4111100000,2023,55030000
F,4730000,21060000,4279000000,2020,25790000
F,44610000,3990000,4273000000,2022,48600000
M,15160000,27590000,4399000000,2024,42750000
F,22140000,21430000,4280000000,2021,43570000
M,30440000,26040000,4146510700,2021,56480000
M,25500000,16160000,4399000000,2021,41660000
M,17270000,5910000,GYEONGGI,2023,23180000
F,20130000,27300000,GANGWON,2021,47430000
F,17640000,25260000,4211000000,2021,42900000
F,49820000,13900000,4280000000,2024,63720000
F,38360000,28830000,4291000000,2022,67190000
F,47300000,24770000,4291000000,2024,72070000
F,3110000,29750000,GANGWON,2023,32860000
F,18130000,7960000,4273000000,2021,26090000
F,11680000,6960000,4399000000,2022,18640000
F,13430000,21890000,4399000000,2021,35320000
M,25090000,18320000,4291000000,2021,43410000
F,18070000,15390000,4399000000,2023,33460000
F,22860000,19840000,GANGWON,2021,42700000
F,19350000,17160000,4399000000,2020,36510000
F,44310000,21400000,4273000000,2022,65710000
F,43300000,26860000,4211000000,2022,70160000
F,4510000,7620000,GYEONGGI,2020,12130000
F,30990000,12200000,4211000000,2023,43190000
F,26450000,29970000,GYEONGGI,2021,56420000
F,36120000,13320000,4146510700,2021,49440000
F,45590000,1350000,4211000000,2022,46940000
F,48170000,11800000,GANGWON,2023,59970000
M,46420000,29310000,4111100000,2023,75730000
M,9170000,3730000,4146510700,2023,12900000
F,3280000,8420000,GYEONGGI,2021,11700000
F,1010000,26420000,GYEONGGI,2023,27430000
M,8450000,9440000,4146510700,2020,17890000
F,26270000,12890000,GYEONGGI,2024,39160000
M,31590000,10260000,4280000000,2023,41850000
M,2330000,13290000,4111100000,2024,15620000
M,32270000,28750000,GANGWON,2021,61020000
M,17580000,20620000,4280000000,2023,38200000
M,20690000,13990000,GYEONGGI,2022,34680000
F,39600000,7790000,4211000000,2021,47390000
M,43550000,11810000,4280000000,2020,55360000
F,15900000,2820000,4211000000,2020,18720000
F,26870000,15090000,4146510700,2024,41960000
M,48730000,27030000,4399000000,2024,75760000
M,31750000,10280000,4279000000,2022,42030000
F,730000,920000,GYEONGGI,2022,1650000
M,36460000,24430000,4279000000,2020,60890000
M,7840000,22230000,4111100000,2023,30070000
F,9090000,16300000,4211000000,2020,25390000
F,5930000,17480000,4280000000,2020,23410000
M,4510000,23090000,4279000000,2022,27600000
F,42620000,4220000,4273000000,2024,46840000
M,26220000,19080000,GYEONGGI,2022,45300000
M,47110000,28390000,4279000000,2022,75500000
M,11360000,19370000,4280000000,2022,30730000
F,44550000,12350000,4280000000,2020,56900000
F,44690000,26170000,4111100000,2023,70860000
F,14630000,3940000,4291000000,2020,18570000
F,30160000,7430000,GANGWON,2021,37590000
F,24340000,9110000,4273000000,2022,33450000
M,7700000,21420000,4279000000,2022,29120000
M,35930000,19770000,GANGWON,2021,55700000
M,6990000,3660000,4273000000,2022,10650000
M,31330000,10410000,4291000000,2022,41740000
F,4530000,990000,4279000000,2022,5520000
M,24350000,16100000,4273000000,2021,40450000
F,27990000,15480000,GANGWON,2020,43470000
M,31190000,3670000,4211000000,2022,34860000
F,2360000,4740000,4280000000,2023,7100000
F,5680000,24080000,4399000000,2021,29760000
M,19470000,2210000,4146510700,2024,21680000
M,32550000,21140000,GYEONGGI,2021,53690000
M,44150000,20390000,4399000000,2020,64540000
M,35900000,28110000,4279000000,2021,64010000
F,46520000,1380000,4279000000,2024,47900000
M,42360000,10690000,4273000000,2023,53050000
M,8270000,14170000,4280000000,2024,22440000
F,17060000,25450000,4291000000,2021,42510000
M,32280000,12640000,4111100000,2024,44920000
M,19970000,7330000,4273000000,2021,27300000
M,10030000,2040000,4111100000,2023,12070000
M,19380000,2460000,4146510700,2023,21840000
M,18660000,13300000,GANGWON,2020,31960000
F,5300000,19810000,4273000000,2023,25110000
M,35000000,1040000,4146510700,2022,36040000
M,5810000,1280000,GYEONGGI,2024,7090000
M,24010000,4670000,4273000000,2024,28680000
M,12560000,26720000,4280000000,2021,39280000
M,29020000,780000,4280000000,2023,29800000
F,25050000,4500000,4279000000,2020,29550000
M,6470000,16410000,GYEONGGI,2020,22880000
F,23380000,6960000,4279000000,2020,30340000
F,18270000,5550000,4111100000,2022,23820000
M,14210000,29130000,4399000000,2023,43340000
M,15910000,1480000,4291000000,2020,17390000
M,34230000,18610000,GYEONGGI,2022,52840000
M,370000,26360000,GANGWON,2024,26730000
F,34080000,27810000,4291000000,2021,61890000
M,7030000,16890000,4291000000,2023,23920000
M,8360000,15750000,4211000000,2023,24110000
M,42490000,5120000,4273000000,2024,47610000
M,20910000,9670000,GANGWON,2023,30580000
M,17050000,11590000,GYEONGGI,2023,28640000
M,31690000,10990000,4279000000,2023,42680000
F,25940000,17510000,4111100000,2023,43450000
F,37920000,560000,4273000000,2022,38480000
M,13720000,11500000,4211000000,2022,25220000
M,30100000,25470000,4111100000,2021,55570000
M,40730000,13530000,GYEONGGI,2023,54260000
F,40980000,12580000,4399000000,2024,53560000
M,19970000,18430000,4291000000,2020,38400000
F,21730000,9930000,4211000000,2021,31660000
M,47110000,1800000,4111100000,2020,48910000
M,17530000,3750000,4279000000,2020,21280000
M,20030000,27470000,4211000000,2023,47500000
M,25050000,7910000,4111100000,2024,32960000
F,22430000,19800000,4211000000,2020,42230000
F,20540000,11230000,4279000000,2020,31770000
M,16920000,14200000,4279000000,2021,31120000
M,29860000,16920000,GANGWON,2024,46780000
F,44370000,13010000,4280000000,2024,57380000
F,17030000,24450000,4291000000,2020,41480000
F,41410000,250000,4273000000,2024,41660000
F,48540000,21610000,4273000000,2021,70150000
M,27080000,10940000,GYEONGGI,2021,38020000
F,7970000,4810000,4146510700,2021,12780000
M,28480000,5630000,GYEONGGI,2023,34110000
F,29530000,4920000,4146510700,2020,34450000
F,35790000,15600000,4211000000,2024,51390000
F,44490000,1840000,4146510700,2021,46330000
F,760000,22570000,4280000000,2020,23330000
F,23400000,24680000,4280000000,2020,48080000
M,14790000,21080000,4291000000,2023,35870000
M,300000,9400000,4111100000,2024,9700000
F,11360000,15020000,4273000000,2024,26380000
F,740000,7320000,4291000000,2021,8060000
M,45570000,17250000,4280000000,2021,62820000
F,27220000,5580000,4111100000,2020,32800000
F,49990000,29340000,GYEONGGI,2024,79330000
M,47050000,23920000,4273000000,2024,70970000
F,730000,14310000,GANGWON,2021,15040000
F,32770000,28050000,4273000000,2022,60820000
M,9680000,25230000,4211000000,2020,34910000
M,9420000,28370000,4399000000,2024,37790000
M,42540000,7250000,4273000000,2023,49790000
F,6190000,1190000,4280000000,2023,7380000
M,42490000,1190000,4211000000,2022,43680000
M,48250000,1790000,4279000000,2021,50040000
M,39570000,7050000,4146510700,2021,46620000
M,39740000,19100000,GYEONGGI,2021,58840000
M,26760000,9610000,GANGWON,2023,36370000
M,5310000,26120000,GYEONGGI,2021,31430000
F,32480000,14770000,4279000000,2023,47250000
F,19740000,8860000,4399000000,2022,28600000
M,10730000,26590000,4273000000,2020,37320000
M,11150000,11370000,4291000000,2024,22520000
M,28680000,6010000,4211000000,2022,34690000
F,37500000,4200000,GANGWON,2023,41700000
F,33670000,17270000,4279000000,2022,50940000
F,25430000,16990000,4399000000,2024,42420000
F,49390000,25710000,GYEONGGI,2020,75100000
F,43690000,4420000,4279000000,2024,48110000
F,39830000,10710000,GANGWON,2023,50540000
F,40330000,27250000,GANGWON,2024,67580000
F,20650000,14930000,4399000000,2022,35580000
F,21650000,24140000,GYEONGGI,2021,45790000
M,47620000,8350000,4280000000,2022,55970000
M,32290000,9810000,GANGWON,2023,42100000
M,45170000,29000000,4211000000,2020,74170000
M,2590000,3850000,4211000000,2024,6440000
F,49690000,2320000,4146510700,2020,52010000
F,33260000,14780000,GYEONGGI,2023,48040000
M,39450000,14360000,4279000000,2024,53810000
F,49530000,21980000,4211000000,2022,71510000
M,38990000,26550000,4399000000,2022,65540000
F,29140000,920000,4279000000,2023,30060000
M,43330000,25750000,GYEONGGI,2024,69080000
F,46610000,600000,4399000000,2022,47210000
F,28080000,13120000,4273000000,2023,41200000
M,36210000,70000,4111100000,2023,36280000
F,46990000,23140000,4211000000,2020,70130000
M,23500000,22320000,4211000000,2022,45820000
M,40800000,3520000,4146510700,2024,44320000
M,19690000,20920000,4280000000,2022,40610000
M,34530000,27010000,4146510700,2022,61540000
F,26020000,29850000,GYEONGGI,2022,55870000
F,30270000,27410000,4146510700,2023,57680000
F,13330000,2590000,4280000000,2021,15920000
M,10620000,12410000,4280000000,2021,23030000
F,45550000,19890000,GANGWON,2020,65440000
M,49850000,3600000,GANGWON,2022,53450000
F,43090000,23230000,4111100000,2021,66320000
F,5290000,27960000,4399000000,2020,33250000
F,32650000,28330000,4273000000,2023,60980000
M,12290000,9460000,4280000000,2022,21750000
F,32220000,13880000,4273000000,2024,46100000
F,40480000,26890000,4211000000,2023,67370000
M,49550000,11670000,4291000000,2020,61220000
F,44850000,29930000,4111100000,2023,74780000
M,1820000,10050000,GYEONGGI,2024,11870000
F,36920000,8900000,4279000000,2023,45820000
M,29690000,13860000,4273000000,2020,43550000
M,30230000,21900000,4146510700,2024,52130000
F,1570000,4370000,4280000000,2024,5940000
M,40980000,3830000,4273000000,2023,44810000
M,25070000,18140000,4279000000,2024,43210000
M,18120000,7530000,4280000000,2023,25650000
M,45440000,13110000,GYEONGGI,2022,58550000
M,46520000,26390000,4291000000,2024,72910000
M,11190000,5420000,4146510700,2023,16610000
F,5440000,7220000,4273000000,2022,12660000
M,48720000,18730000,GANGWON,2024,67450000
M,7080000,3000000,4111100000,2022,10080000
F,48490000,25930000,4273000000,2024,74420000
F,26630000,20290000,4273000000,2020,46920000
F,46430000,9420000,4279000000,2020,55850000
F,30110000,27310000,4279000000,2023,57420000
F,19670000,19850000,4111100000,2021,39520000
F,25050000,25380000,4273000000,2020,50430000
F,36750000,16920000,4399000000,2021,53670000
M,31390000,8440000,GYEONGGI,2022,39830000
M,9310000,2200000,4279000000,2022,11510000
F,23280000,16260000,4279000000,2021,39540000
M,44970000,1210000,4399000000,2023,46180000
M,35000000,28030000,4280000000,2024,63030000
M,32050000,20140000,4273000000,2021,52190000
F,21940000,27480000,4111100000,2021,49420000
F,44450000,25120000,4279000000,2021,69570000
M,420000,7310000,4111100000,2021,7730000
F,27700000,21910000,4111100000,2021,49610000
M,30240000,13780000,GYEONGGI,2023,44020000
M,11100000,23650000,GANGWON,2020,34750000
M,25770000,9100000,4279000000,2024,34870000
M,49200000,22630000,4146510700,2020,71830000
F,40000000,2270000,4280000000,2021,42270000
F,31270000,4890000,4111100000,2020,36160000
F,38810000,21260000,4279000000,2023,60070000
M,13610000,26000000,4280000000,2022,39610000
F,8520000,26520000,4146510700,2020,35040000
M,18550000,26330000,4279000000,2024,44880000
F,21970000,8770000,4273000000,2023,30740000
M,42630000,22720000,4111100000,2022,65350000
M,33830000,10150000,4146510700,2023,43980000
M,40210000,16810000,4273000000,2021,57020000
F,14280000,10000,4111100000,2022,14290000
F,48120000,24190000,4211000000,2024,72310000
F,39380000,2570000,4291000000,2022,41950000
F,25820000,19330000,4399000000,2024,45150000
M,18430000,6960000,4111100000,2021,25390000
F,43420000,13040000,4146510700,2024,56460000
F,48960000,12540000,4146510700,2023,61500000
M,7080000,5470000,4291000000,2020,12550000
M,16410000,24570000,4279000000,2023,40980000
M,29320000,10200000,4399000000,2023,39520000
F,49100000,14090000,4280000000,2022,63190000
M,17250000,21690000,4111100000,2021,38940000
M,26560000,880000,4279000000,2020,27440000
M,1900000,4490000,4273000000,2024,6390000
F,39200000,25900000,4280000000,2022,65100000
M,46200000,6350000,4399000000,2021,52550000
F,32790000,3800000,4279000000,2020,36590000
F,30970000,16450000,GANGWON,2023,47420000
M,24530000,17420000,4280000000,2021,41950000
M,7390000,25370000,GYEONGGI,2021,32760000
F,38130000,28500000,GYEONGGI,2021,66630000
M,44230000,22900000,4111100000,2023,67130000
M,47270000,28800000,4111100000,2024,76070000
F,44850000,8410000,4111100000,2022,53260000
F,7870000,3400000,4399000000,2024,11270000
M,18310000,20600000,GANGWON,2020,38910000
F,5870000,21390000,4279000000,2022,27260000
M,46500000,16970000,4273000000,2020,63470000
M,29480000,16070000,4211000000,2023,45550000
M,42610000,20850000,4146510700,2024,63460000
F,27050000,25580000,4273000000,2021,52630000
M,34640000,27960000,4279000000,2022,62600000
M,4300000,27540000,GANGWON,2021,31840000
M,48630000,20500000,4399000000,2020,69130000
F,6760000,20060000,4280000000,2021,26820000
F,48710000,16550000,4273000000,2021,65260000
F,40170000,13270000,4280000000,2023,53440000
F,1630000,7760000,4211000000,2023,9390000
F,15120000,24890000,4279000000,2024,40010000
M,25870000,25110000,GANGWON,2020,50980000
F,49870000,21530000,4279000000,2023,71400000
F,17570000,14930000,4146510700,2023,32500000
F,10110000,23380000,4399000000,2024,33490000
M,24140000,26380000,4146510700,2022,50520000
F,34590000,18470000,4279000000,2024,53060000
F,25580000,11260000,4146510700,2021,36840000
M,9030000,21170000,4291000000,2021,30200000
F,7610000,6490000,4279000000,2023,14100000
M,32980000,24410000,GANGWON,2023,57390000
M,42710000,11490000,4273000000,2024,54200000
M,20480000,25500000,GANGWON,2024,45980000
M,13720000,26620000,4291000000,2020,40340000
M,14370000,2940000,4273000000,2021,17310000
F,32430000,18820000,4291000000,2024,51250000
M,31760000,11400000,4273000000,2022,43160000
M,32960000,4930000,GANGWON,2020,37890000
F,5270000,1150000,4279000000,2024,6420000
M,26370000,4920000,4111100000,2023,31290000
F,40820000,150000,GYEONGGI,2024,40970000
F,15020000,10060000,GYEONGGI,2023,25080000
F,1760000,9010000,4291000000,2023,10770000
M,3540000,16130000,GYEONGGI,2021,19670000
M,8430000,20540000,GANGWON,2021,28970000
M,24160000,20820000,4280000000,2024,44980000
F,4610000,10390000,4291000000,2024,15000000
M,37690000,6180000,4273000000,2022,43870000
M,49540000,14920000,4399000000,2020,64460000
M,5350000,26440000,4146510700,2020,31790000
F,13690000,8200000,GANGWON,2024,21890000
F,39940000,21940000,4273000000,2021,61880000
M,35330000,13450000,4280000000,2022,48780000
M,14900000,4460000,4399000000,2020,19360000
M,38460000,28530000,GYEONGGI,2024,66990000
M,9010000,13770000,4280000000,2021,22780000
F,8300000,1800000,4291000000,2021,10100000
F,44310000,950000,4211000000,2021,45260000
F,45780000,20430000,4211000000,2023,66210000
F,32580000,29190000,GYEONGGI,2021,61770000
M,6670000,20530000,4211000000,2024,27200000
M,5730000,25950000,4211000000,2022,31680000
M,22800000,26430000,4273000000,2024,49230000
F,14770000,26920000,4273000000,2021,41690000
M,220000,20880000,4146510700,2022,21100000
F,48440000,25450000,4279000000,2020,73890000
F,6690000,29510000,GYEONGGI,2020,36200000
M,16960000,26760000,4211000000,2024,43720000
M,47420000,1710000,4146510700,2022,49130000
M,37180000,29110000,GYEONGGI,2024,66290000
F,21380000,21820000,4211000000,2022,43200000
M,27940000,28640000,GANGWON,2022,56580000
F,14100000,6840000,4111100000,2024,20940000
M,19310000,11630000,GANGWON,2022,30940000
F,29720000,21670000,4399000000,2021,51390000
F,29530000,26610000,GYEONGGI,2022,56140000
M,13580000,24740000,4279000000,2022,38320000
F,5590000,25290000,4399000000,2024,30880000
F,33070000,11340000,4146510700,2020,44410000
M,3290000,16550000,4146510700,2023,19840000
F,17460000,21460000,4211000000,2022,38920000
M,34350000,6840000,4399000000,2023,41190000
F,26270000,10270000,4211000000,2022,36540000
M,35560000,9070000,GYEONGGI,2024,44630000
M,23610000,22360000,4146510700,2024,45970000
F,38020000,20740000,4111100000,2022,58760000
F,47110000,130000,4146510700,2024,47240000
F,140000,20580000,4273000000,2024,20720000
F,3790000,24410000,4280000000,2022,28200000
F,43670000,29700000,4279000000,2020,73370000
M,33690000,9850000,4399000000,2022,43540000
F,5250000,270000,4211000000,2020,5520000
M,37700000,14290000,4280000000,2024,51990000
M,14400000,21390000,4280000000,2020,35790000
F,39230000,28560000,GANGWON,2024,67790000
M,27140000,1390000,4291000000,2020,28530000
M,5140000,4140000,GANGWON,2020,9280000
M,12310000,22630000,GANGWON,2022,34940000
M,3310000,780000,4279000000,2020,4090000
F,40000,7870000,4273000000,2024,7910000
M,44300000,10100000,4146510700,2022,54400000
F,29570000,27600000,GANGWON,2020,57170000
F,12030000,16230000,GYEONGGI,2022,28260000
M,33320000,17490000,4146510700,2023,50810000
F,18800000,5750000,4273000000,2022,24550000
F,18580000,13080000,4211000000,2023,31660000
F,31670000,17110000,4291000000,2023,48780000
M,1940000,24640000,4146510700,2022,26580000
F,31450000,11560000,4399000000,2024,43010000
F,43330000,2760000,4279000000,2024,46090000
F,30350000,15580000,4280000000,2024,45930000
M,33210000,2850000,4211000000,2021,36060000
F,6330000,19010000,4273000000,2023,25340000
M,21580000,18790000,GANGWON,2022,40370000
M,45500000,23690000,GYEONGGI,2024,69190000
M,15540000,11180000,GYEONGGI,2024,26720000
M,23800000,10800000,4291000000,2022,34600000
M,29190000,21020000,4273000000,2023,50210000
M,40000,15720000,4211000000,2022,15760000
F,32300000,3890000,4399000000,2021,36190000
M,41630000,27980000,4280000000,2021,69610000
F,20080000,5680000,GANGWON,2022,25760000
F,38950000,27940000,4279000000,2023,66890000
M,3230000,1250000,4111100000,2024,4480000
F,1090000,29420000,4111100000,2021,30510000
F,26000000,18890000,GANGWON,2021,44890000
F,23260000,6620000,4211000000,2023,29880000
F,23730000,18390000,GANGWON,2021,42120000
M,40780000,14010000,4273000000,2021,54790000
F,12080000,29610000,4111100000,2023,41690000
M,18380000,27520000,4291000000,2022,45900000
F,24960000,23780000,4273000000,2024,48740000
F,41820000,24340000,4111100000,2024,66160000
M,1530000,18910000,4399000000,2021,20440000
F,49670000,5020000,4280000000,2024,54690000
F,37960000,9300000,GYEONGGI,2022,47260000
F,48590000,25450000,4273000000,2021,74040000
M,42170000,10920000,GYEONGGI,2024,53090000
F,2070000,18420000,GYEONGGI,2020,20490000
M,7460000,23830000,4111100000,2020,31290000
F,18240000,29030000,4273000000,2020,47270000
M,11030000,18960000,4280000000,2020,29990000
M,48190000,4780000,4399000000,2020,52970000
F,38550000,20540000,4146510700,2021,59090000
F,20460000,1290000,4291000000,2023,21750000
M,24430000,16570000,GYEONGGI,2023,41000000
M,1420000,13640000,4280000000,2021,15060000
F,35300000,1430000,4279000000,2021,36730000
M,16440000,25080000,4279000000,2022,41520000
F,26610000,26700000,4146510700,2023,53310000
F,21670000,12100000,4146510700,2020,33770000
F,47550000,26850000,4146510700,2021,74400000
F,14570000,3240000,4291000000,2020,17810000
M,8460000,8650000,4291000000,2023,17110000
F,24250000,18380000,4399000000,2024,42630000
M,13830000,12590000,GYEONGGI,2024,26420000
F,14740000,5380000,4211000000,2021,20120000
M,47980000,17820000,4279000000,2022,65800000
F,10020000,25240000,4111100000,2020,35260000
M,33510000,29450000,4111100000,2021,62960000
M,30740000,2660000,4146510700,2022,33400000
F,48520000,28700000,GANGWON,2020,77220000
F,21220000,18210000,4279000000,2023,39430000
F,38670000,29800000,4211000000,2024,68470000
F,37640000,12180000,4211000000,2022,49820000
M,23040000,20840000,4111100000,2020,43880000
F,38180000,15420000,GANGWON,2021,53600000
M,920000,4350000,4211000000,2020,5270000
M,42540000,1950000,4279000000,2021,44490000
F,15760000,15000000,GYEONGGI,2024,30760000
M,47450000,23270000,4280000000,2024,70720000
M,48590000,970000,GANGWON,2020,49560000
M,11910000,12850000,4211000000,2020,24760000
M,41700000,24470000,GANGWON,2021,66170000
F,35730000,27530000,GANGWON,2021,63260000
F,48110000,12250000,GYEONGGI,2022,60360000
F,19260000,26060000,4279000000,2022,45320000
F,36890000,27840000,4111100000,2022,64730000
M,28530000,1310000,GYEONGGI,2020,29840000
M,30470000,980000,4211000000,2022,31450000
F,530000,4440000,4146510700,2020,4970000
F,43940000,20770000,GYEONGGI,2024,64710000
F,28860000,480000,4146510700,2023,29340000
M,9940000,26470000,4273000000,2024,36410000
F,3660000,7720000,4111100000,2020,11380000
F,36270000,6540000,4279000000,2020,42810000
F,43790000,24770000,4280000000,2023,68560000
M,21560000,29190000,GANGWON,2021,50750000
M,33240000,5270000,4146510700,2021,38510000
M,6630000,8910000,4280000000,2021,15540000
M,6830000,24410000,4280000000,2022,31240000
M,44100000,12430000,4146510700,2021,56530000
M,32140000,24270000,4280000000,2022,56410000
M,38200000,11400000,GANGWON,2022,49600000
M,41980000,5100000,4399000000,2021,47080000
F,4620000,14880000,4273000000,2021,19500000
F,40790000,26570000,4146510700,2023,67360000
M,35670000,9790000,GANGWON,2023,45460000
M,41190000,29220000,4111100000,2022,70410000
F,10450000,20000,4146510700,2023,10470000
M,23690000,28870000,GANGWON,2022,52560000
M,29140000,15120000,GANGWON,2020,44260000
M,28650000,13410000,GYEONGGI,2022,42060000
F,21280000,18420000,4399000000,2022,39700000
F,290000,15640000,4146510700,2023,15930000
F,1380000,27040000,4279000000,2020,28420000
F,40170000,16980000,GANGWON,2024,57150000
F,1870000,23820000,4273000000,2024,25690000
M,41090000,8910000,GYEONGGI,2024,50000000
F,3950000,17750000,GANGWON,2020,21700000
M,46690000,17340000,4146510700,2021,64030000
M,49030000,10720000,4211000000,2020,59750000
F,2880000,25100000,GANGWON,2023,27980000
F,2460000,1260000,4291000000,2022,3720000
M,28070000,3680000,4211000000,2022,31750000
M,6470000,13090000,GANGWON,2023,19560000
M,690000,2020000,4280000000,2023,2710000
F,16160000,4630000,GANGWON,2022,20790000
F,2570000,25210000,4111100000,2021,27780000
F,7490000,8370000,4280000000,2021,15860000
F,4670000,2210000,4146510700,2021,6880000
F,19870000,19300000,4273000000,2023,39170000
M,13170000,19970000,4211000000,2022,33140000
F,13050000,16830000,4279000000,2022,29880000
M,40730000,10470000,GYEONGGI,2022,51200000
M,20580000,21150000,4273000000,2020,41730000
M,33160000,14040000,4280000000,2020,47200000
F,20590000,5600000,GYEONGGI,2024,26190000
F,14020000,9180000,4211000000,2020,23200000
F,39150000,14630000,4279000000,2021,53780000
M,31690000,19710000,4291000000,2021,51400000
M,36020000,4930000,4291000000,2021,40950000
M,13430000,14100000,4279000000,2021,27530000
M,48470000,26620000,GYEONGGI,2024,75090000
M,25040000,29900000,4146510700,2021,54940000
M,25460000,24830000,GYEONGGI,2023,50290000
F,34260000,22490000,GANGWON,2023,56750000
F,28840000,8950000,GYEONGGI,2023,37790000
F,18640000,22630000,4146510700,2020,41270000
F,25420000,7760000,4273000000,2022,33180000
M,4390000,13420000,4211000000,2024,17810000
M,22660000,14740000,GYEONGGI,2023,37400000
F,120000,26410000,4211000000,2023,26530000
M,37770000,14260000,4280000000,2021,52030000
F,17390000,29240000,4291000000,2023,46630000
F,16790000,22870000,4291000000,2021,39660000
F,3550000,15430000,4146510700,2021,18980000
M,6500000,27330000,4280000000,2022,33830000
F,36040000,2590000,4291000000,2020,38630000
F,2000000,9970000,4146510700,2021,11970000
F,1550000,17790000,GYEONGGI,2021,19340000
M,39710000,29470000,4280000000,2022,69180000
M,29760000,25550000,GANGWON,2021,55310000
F,20200000,6770000,GANGWON,2024,26970000
M,12850000,7100000,GANGWON,2020,19950000
M,9210000,11810000,4273000000,2024,21020000
M,28190000,29670000,GANGWON,2023,57860000
M,21300000,21000000,4280000000,2020,42300000
M,8510000,17890000,4111100000,2023,26400000
M,17910000,9130000,4291000000,2021,27040000
M,27410000,3250000,GANGWON,2022,30660000
M,240000,20400000,4280000000,2024,20640000
M,42520000,12330000,4399000000,2023,54850000
M,16860000,27150000,GYEONGGI,2021,44010000
F,39550000,6520000,4273000000,2024,46070000
F,23210000,22110000,4211000000,2024,45320000
M,25440000,18960000,4146510700,2023,44400000
F,37210000,4800000,4399000000,2021,42010000
F,12810000,25700000,4399000000,2022,38510000
M,25130000,3480000,4273000000,2023,28610000
M,10770000,17550000,4146510700,2024,28320000
M,19360000,260000,4273000000,2024,19620000
F,24880000,470000,GANGWON,2020,25350000
F,46780000,4520000,4211000000,2021,51300000
M,22920000,10640000,4146510700,2020,33560000
M,24330000,21320000,4280000000,2022,45650000
M,18600000,13930000,4291000000,2023,32530000
F,41270000,12970000,4273000000,2024,54240000
F,41700000,18600000,4211000000,2021,60300000
F,9770000,10450000,GYEONGGI,2024,20220000
F,27660000,4770000,4111100000,2020,32430000
M,29840000,12230000,GYEONGGI,2020,42070000
M,4760000,4180000,4111100000,2023,8940000
M,15510000,9600000,4279000000,2021,25110000
M,31270000,3090000,4280000000,2021,34360000
F,29270000,9640000,4279000000,2023,38910000
F,49350000,16680000,4273000000,2020,66030000
M,17260000,23540000,4273000000,2020,40800000
M,4030000,3560000,4111100000,2020,7590000
F,31570000,4290000,4146510700,2024,35860000
M,32740000,3180000,4211000000,2022,35920000
F,25710000,29410000,GANGWON,2020,55120000
M,45930000,3440000,4399000000,2022,49370000
M,16200000,13430000,4273000000,2022,29630000
M,43560000,7980000,4279000000,2021,51540000
M,36420000,6630000,4279000000,2023,43050000
M,49900000,11420000,GYEONGGI,2024,61320000
M,49300000,7130000,4280000000,2022,56430000
M,21480000,28530000,4111100000,2024,50010000
F,13210000,27030000,4399000000,2021,40240000
F,35880000,28080000,4111100000,2020,63960000
F,32160000,21570000,4273000000,2022,53730000
F,40240000,23550000,4291000000,2023,63790000
F,8270000,13150000,4399000000,2021,21420000
M,3900000,24640000,GYEONGGI,2024,28540000
M,16870000,140000,4279000000,2020,17010000
F,43840000,24450000,GYEONGGI,2024,68290000
M,37020000,5710000,4273000000,2023,42730000
F,15070000,4220000,4291000000,2022,19290000
F,9940000,24830000,GANGWON,2023,34770000
M,6130000,5180000,4399000000,2024,11310000
M,17420000,25820000,4111100000,2024,43240000
M,3660000,5910000,4399000000,2023,9570000
F,5650000,19960000,4279000000,2023,25610000
M,11910000,28240000,4111100000,2023,40150000
F,17520000,18290000,GANGWON,2020,35810000
F,30010000,1890000,GANGWON,2024,31900000
F,49570000,7060000,4280000000,2021,56630000
M,9480000,24430000,4111100000,2020,33910000
M,5000000,17310000,4211000000,2020,22310000
F,24850000,29420000,4291000000,2020,54270000
M,12490000,25850000,4211000000,2021,38340000
M,24480000,11920000,GANGWON,2023,36400000
M,26670000,25080000,4111100000,2024,51750000
F,11730000,6550000,4280000000,2022,18280000
F,2170000,5430000,4399000000,2022,7600000
M,9780000,24410000,4399000000,2024,34190000
F,14240000,18570000,4399000000,2021,32810000
M,42460000,28840000,4280000000,2022,71300000
M,6910000,27550000,4273000000,2020,34460000
M,1010000,14380000,4111100000,2022,15390000
M,15660000,550000,4211000000,2024,16210000
F,25050000,7510000,4291000000,2020,32560000
F,1780000,21870000,GANGWON,2022,23650000
F,36500000,25420000,4291000000,2024,61920000
M,35630000,9660000,GANGWON,2021,45290000
M,22740000,23910000,4111100000,2024,46650000
M,21030000,7700000,4111100000,2021,28730000
F,33840000,7000000,GYEONGGI,2020,40840000
M,27930000,10420000,4211000000,2024,38350000
F,7630000,3800000,4279000000,2023,11430000
F,4320000,7410000,GANGWON,2023,11730000
F,2860000,12530000,4146510700,2023,15390000
F,3830000,14030000,4279000000,2023,17860000
F,4980000,26100000,4399000000,2023,31080000
F,17820000,7460000,4291000000,2021,25280000
M,15050000,26570000,4111100000,2024,41620000
M,770000,29020000,4146510700,2020,29790000
F,2710000,26700000,GANGWON,2023,29410000
F,23330000,20280000,4273000000,2023,43610000
M,1740000,1770000,GANGWON,2020,3510000
F,43510000,29060000,4291000000,2020,72570000
F,23490000,21550000,GANGWON,2023,45040000
M,16820000,11530000,GANGWON,2021,28350000
F,8660000,1180000,4280000000,2020,9840000
F,28860000,12970000,4211000000,2024,41830000
F,9470000,28690000,4279000000,2024,38160000
M,39650000,6730000,4273000000,2021,46380000
M,33030000,1980000,4111100000,2022,35010000
M,49750000,7440000,GANGWON,2021,57190000
F,12380000,29910000,4273000000,2023,42290000
F,31070000,8070000,GYEONGGI,2022,39140000
M,42770000,7690000,GANGWON,2023,50460000
F,9270000,15260000,4280000000,2024,24530000
F,6680000,9850000,4280000000,2020,16530000
F,34330000,16390000,4146510700,2023,50720000
F,28690000,2940000,4399000000,2024,31630000
F,28670000,19250000,4291000000,2021,47920000
M,40630000,5600000,4279000000,2023,46230000
F,870000,23880000,GYEONGGI,2024,24750000
M,35370000,15980000,4291000000,2020,51350000
F,15520000,18850000,4291000000,2023,34370000
M,8160000,12120000,4146510700,2024,20280000
F,10670000,25690000,4280000000,2023,36360000
M,45580000,18130000,4211000000,2020,63710000
F,20620000,18830000,4273000000,2023,39450000
M,13320000,9630000,4111100000,2023,22950000
F,46120000,10810000,4211000000,2024,56930000
M,9240000,10330000,4211000000,2022,19570000
F,19130000,13600000,4399000000,2023,32730000
M,7440000,1070000,4399000000,2022,8510000
M,36120000,12340000,4211000000,2021,48460000
F,29960000,4150000,4280000000,2023,34110000
F,33810000,3150000,4291000000,2022,36960000
M,4460000,17630000,4273000000,2021,22090000
F,21610000,16880000,4291000000,2024,38490000
M,2510000,29540000,4291000000,2023,32050000
M,49570000,10770000,4291000000,2024,60340000
M,35460000,20600000,4273000000,2021,56060000
F,37550000,880000,4273000000,2024,38430000
M,34970000,17360000,4146510700,2024,52330000
M,35730000,15990000,4279000000,2020,51720000
F,36290000,27920000,4211000000,2021,64210000
F,26520000,26530000,GANGWON,2024,53050000
F,35640000,7690000,4146510700,2022,43330000
F,44290000,28590000,4146510700,2021,72880000
M,8350000,9290000,4111100000,2020,17640000
M,37410000,28780000,GANGWON,2023,66190000
M,20410000,10520000,4399000000,2024,30930000
M,20170000,4060000,4111100000,2022,24230000
F,3800000,4460000,4399000000,2020,8260000
M,38880000,10590000,4279000000,2021,49470000
M,48650000,10510000,GYEONGGI,2024,59160000
F,44760000,18960000,4399000000,2020,63720000
M,16820000,12460000,4291000000,2020,29280000
M,0,690000,4399000000,2022,690000
M,32840000,9100000,GANGWON,2023,41940000
M,46930000,1570000,4273000000,2023,48500000
M,3860000,4260000,GANGWON,2023,8120000
M,25200000,3590000,4279000000,2021,28790000
F,10600000,15870000,4146510700,2020,26470000
F,13500000,21440000,4291000000,2021,34940000
M,18670000,24810000,GYEONGGI,2020,43480000
M,22640000,1350000,4279000000,2022,23990000
F,48450000,18290000,4146510700,2022,66740000
M,800000,20910000,4280000000,2021,21710000
M,22250000,25980000,GANGWON,2021,48230000
M,21120000,830000,4279000000,2022,21950000
F,110000,6640000,GANGWON,2024,6750000
M,47720000,9540000,GYEONGGI,2023,57260000
F,24970000,8480000,4146510700,2023,33450000
M,12440000,8120000,GANGWON,2022,20560000
F,14360000,26670000,4273000000,2023,41030000
F,4280000,18000000,4399000000,2024,22280000
M,4520000,2330000,4111100000,2024,6850000
F,12980000,29550000,GYEONGGI,2020,42530000
M,21080000,27730000,4111100000,2021,48810000
F,44520000,15510000,4211000000,2023,60030000
M,42790000,18930000,4399000000,2024,61720000
M,35280000,23260000,GYEONGGI,2021,58540000
F,35580000,17610000,4279000000,2021,53190000
M,45020000,28540000,4273000000,2020,73560000
M,39190000,13390000,4279000000,2021,52580000
F,46530000,18510000,4280000000,2021,65040000
M,8820000,3820000,4211000000,2022,12640000
M,23700000,29640000,4273000000,2020,53340000
F,29300000,10430000,GANGWON,2020,39730000
F,31810000,3140000,GANGWON,2023,34950000
M,36530000,8340000,4291000000,2021,44870000
M,14410000,19590000,GANGWON,2023,34000000
F,15210000,11640000,4146510700,2024,26850000
F,14100000,9940000,4211000000,2021,24040000
M,25010000,10660000,4146510700,2024,35670000
F,44000000,7990000,4399000000,2022,51990000
M,25590000,25620000,4291000000,2021,51210000
M,21970000,18940000,4291000000,2023,40910000
M,24140000,8040000,GANGWON,2023,32180000
M,13280000,8620000,4273000000,2021,21900000
M,27160000,9140000,4399000000,2023,36300000
F,12210000,490000,4280000000,2021,12700000
F,30410000,10550000,4211000000,2020,40960000
F,23540000,26330000,4211000000,2023,49870000
F,13860000,27600000,GYEONGGI,2021,41460000
M,24980000,9870000,4279000000,2021,34850000
M,38970000,25180000,GANGWON,2023,64150000
M,38680000,12060000,GYEONGGI,2020,50740000
M,20270000,11150000,4280000000,2023,31420000
F,1920000,11110000,4291000000,2021,13030000
M,43860000,3330000,4111100000,2020,47190000
M,16140000,24140000,4280000000,2024,40280000
F,26350000,13610000,4280000000,2022,39960000
F,26290000,13910000,4273000000,2023,40200000
F,5240000,3660000,4273000000,2021,8900000
F,21850000,11120000,4273000000,2020,32970000
M,22530000,2790000,4273000000,2020,25320000
M,10030000,10570000,4279000000,2024,20600000
F,23700000,11300000,GANGWON,2023,35000000
M,24590000,20110000,4211000000,2020,44700000
M,21670000,14410000,GANGWON,2024,36080000
M,16210000,10680000,GANGWON,2021,26890000
F,37350000,11840000,4211000000,2024,49190000
M,16160000,8230000,4273000000,2023,24390000
F,11750000,3940000,GANGWON,2024,15690000
M,6460000,10940000,4279000000,2020,17400000
M,340000,4760000,4273000000,2020,5100000
M,47810000,27320000,4279000000,2022,75130000
F,16520000,20860000,GYEONGGI,2024,37380000
M,27570000,4830000,GANGWON,2021,32400000
F,21880000,18550000,4146510700,2023,40430000
F,27000000,6120000,4279000000,2022,33120000
F,17910000,10990000,GYEONGGI,2024,28900000
M,11300000,7700000,4399000000,2021,19000000
M,5930000,14370000,4399000000,2022,20300000
M,39940000,21570000,GYEONGGI,2020,61510000
M,3330000,18950000,4291000000,2023,22280000
F,28860000,17550000,4291000000,2024,46410000
F,22480000,1910000,4273000000,2021,24390000
F,29650000,1500000,4291000000,2020,31150000
M,42240000,2970000,4399000000,2022,45210000
F,14690000,2710000,4291000000,2023,17400000
M,49350000,8640000,4146510700,2022,57990000
F,10850000,4710000,4399000000,2022,15560000
M,43960000,14840000,4279000000,2021,58800000
M,9240000,910000,4280000000,2020,10150000
F,13920000,2050000,4291000000,2024,15970000
F,10760000,650000,4291000000,2021,11410000
F,18090000,17770000,GANGWON,2023,35860000
F,3430000,27200000,4211000000,2022,30630000
M,34320000,19350000,4146510700,2023,53670000
F,22640000,6550000,4399000000,2021,29190000
F,21600000,4100000,4399000000,2021,25700000
F,34220000,22900000,4111100000,2024,57120000
M,28730000,21650000,4211000000,2022,50380000
M,7790000,21450000,4291000000,2021,29240000
F,6980000,20980000,GYEONGGI,2023,27960000
M,37370000,13150000,GANGWON,2024,50520000
F,4530000,15210000,4279000000,2023,19740000
M,38520000,7130000,GANGWON,2022,45650000
M,34090000,9880000,4291000000,2024,43970000
M,34200000,20810000,4111100000,2024,55010000
M,11530000,7560000,4280000000,2024,19090000
F,24930000,9330000,4399000000,2020,34260000
F,27930000,3480000,4279000000,2024,31410000
F,18480000,7160000,4211000000,2023,25640000
M,20960000,29170000,4291000000,2023,50130000
F,35020000,10480000,4146510700,2022,45500000
F,43110000,5500000,GYEONGGI,2021,48610000
F,1840000,4870000,GANGWON,2021,6710000
M,34540000,17240000,4111100000,2020,51780000
M,46900000,29160000,4280000000,2024,76060000
M,32370000,4330000,4273000000,2020,36700000
F,21930000,17340000,GYEONGGI,2022,39270000
F,30990000,9370000,4291000000,2022,40360000
F,45840000,5170000,4280000000,2021,51010000
M,24190000,3310000,GYEONGGI,2022,27500000
M,25220000,3330000,GYEONGGI,2024,28550000
F,15550000,29350000,4399000000,2023,44900000
M,5660000,15520000,GYEONGGI,2022,21180000
M,26230000,5000000,4146510700,2020,31230000
M,37870000,2660000,4280000000,2024,40530000
M,9040000,15170000,4291000000,2022,24210000
F,27900000,23770000,4291000000,2022,51670000
M,3200000,21390000,4146510700,2024,24590000
M,13450000,25720000,4211000000,2022,39170000
M,22070000,15970000,4280000000,2023,38040000
M,27320000,22770000,GYEONGGI,2021,50090000
F,25650000,14510000,4111100000,2024,40160000
F,21750000,27120000,4279000000,2020,48870000
M,40270000,19110000,4280000000,2022,59380000
M,42010000,2190000,4273000000,2021,44200000
M,4420000,15530000,4111100000,2020,19950000
M,37440000,16070000,4146510700,2020,53510000
M,35500000,19620000,GYEONGGI,2023,55120000
M,7340000,20730000,4211000000,2021,28070000
F,5030000,5230000,4273000000,2024,10260000
M,17670000,20500000,4211000000,2021,38170000
F,26040000,23110000,4211000000,2021,49150000
F,7600000,11420000,GANGWON,2020,19020000
M,20800000,26360000,4399000000,2023,47160000
F,31680000,5830000,4273000000,2023,37510000
F,13650000,9970000,4279000000,2021,23620000
F,27700000,13680000,4399000000,2021,41380000
F,42100000,24710000,4273000000,2022,66810000
F,46590000,12820000,4211000000,2020,59410000
F,21480000,3250000,4399000000,2024,24730000
M,35110000,8990000,4273000000,2024,44100000
F,33210000,21080000,4279000000,2023,54290000
F,38800000,9970000,4111100000,2020,48770000
F,26840000,20100000,4280000000,2023,46940000
M,8550000,5270000,GYEONGGI,2024,13820000
F,15450000,4930000,4273000000,2021,20380000
M,2740000,260000,4279000000,2020,3000000
F,35140000,16090000,4280000000,2020,51230000
M,21950000,22290000,4399000000,2022,44240000
M,43460000,5810000,4273000000,2021,49270000
F,23310000,8210000,4273000000,2021,31520000
F,6350000,8530000,4146510700,2023,14880000
M,15040000,1340000,4273000000,2020,16380000
F,34140000,10720000,GYEONGGI,2023,44860000
M,40790000,3150000,4146510700,2021,43940000
M,990000,18500000,4280000000,2022,19490000
M,28610000,20130000,4399000000,2020,48740000
M,30750000,18620000,4399000000,2021,49370000
M,45180000,28370000,4291000000,2022,73550000
F,41400000,18410000,4291000000,2024,59810000
M,49800000,1720000,4280000000,2021,51520000
M,17260000,11710000,GANGWON,2024,28970000
F,15510000,21230000,4279000000,2023,36740000
M,38820000,22590000,GANGWON,2024,61410000
F,15460000,20230000,4279000000,2021,35690000
F,37660000,1330000,4146510700,2024,38990000
F,47140000,3440000,4280000000,2020,50580000
M,45870000,3110000,4279000000,2021,48980000
M,46630000,29460000,4291000000,2022,76090000
M,40170000,24940000,4291000000,2024,65110000
F,1750000,13920000,4211000000,2020,15670000
M,8480000,18330000,4279000000,2023,26810000
F,32420000,13300000,4280000000,2023,45720000
M,3450000,29940000,4111100000,2024,33390000
F,28930000,4580000,4146510700,2023,33510000
M,40420000,23390000,4273000000,2022,63810000
M,29740000,27980000,4273000000,2021,57720000
M,8030000,24300000,4279000000,2020,32330000
F,42960000,3250000,GANGWON,2024,46210000
F,36440000,6900000,4146510700,2023,43340000
M,40900000,22850000,4399000000,2021,63750000
M,16600000,12040000,GYEONGGI,2022,28640000
F,30360000,8030000,4273000000,2023,38390000
F,41460000,17520000,4291000000,2023,58980000
F,30500000,16570000,4146510700,2020,47070000
M,38350000,25420000,GANGWON,2022,63770000
F,24110000,11960000,4280000000,2022,36070000
M,15430000,3630000,GANGWON,2024,19060000
F,2320000,7970000,4146510700,2020,10290000
M,480000,10620000,4399000000,2024,11100000
F,24510000,4970000,4273000000,2020,29480000
F,47890000,3740000,4291000000,2022,51630000
F,27560000,10740000,4111100000,2020,38300000
F,27980000,28020000,4280000000,2020,56000000
F,5380000,25880000,4291000000,2020,31260000
M,32700000,12150000,4399000000,2021,44850000
F,25850000,22540000,GYEONGGI,2021,48390000
F,39200000,12810000,4399000000,2022,52010000
F,48650000,20000,4399000000,2020,48670000
M,33620000,16030000,4273000000,2022,49650000
F,48320000,8780000,4146510700,2021,57100000
M,39000000,2040000,4146510700,2020,41040000
F,6850000,5170000,4291000000,2024,12020000
F,9520000,1380000,GYEONGGI,2021,10900000
M,19640000,10480000,GYEONGGI,2021,30120000
F,13430000,5560000,GANGWON,2021,18990000
M,21090000,1490000,4111100000,2020,22580000
M,5300000,11620000,4399000000,2023,16920000
F,21680000,18320000,4111100000,2024,40000000
M,30160000,12490000,4211000000,2024,42650000
F,5110000,24950000,4279000000,2022,30060000
F,31610000,16040000,4399000000,2020,47650000
M,33520000,18370000,4111100000,2021,51890000
M,46660000,29380000,4273000000,2023,76040000
M,10730000,10380000,4279000000,2020,21110000
M,8420000,26110000,GYEONGGI,2020,34530000
F,49420000,14570000,4399000000,2023,63990000
F,28110000,25610000,4399000000,2021,53720000
M,5890000,5260000,GYEONGGI,2020,11150000
F,23640000,29230000,GANGWON,2024,52870000
F,8020000,6130000,4273000000,2024,14150000
F,45610000,18160000,4399000000,2023,63770000
F,14710000,7210000,4111100000,2021,21920000
M,13530000,6810000,4399000000,2023,20340000
M,4860000,23470000,4279000000,2020,28330000
F,49460000,20880000,4399000000,2024,70340000
M,14050000,23770000,4111100000,2022,37820000
M,28180000,16940000,4280000000,2023,45120000
M,42850000,19780000,4279000000,2022,62630000
F,20150000,80000,4291000000,2022,20230000
F,41980000,13030000,4291000000,2024,55010000
F,18920000,24200000,4279000000,2023,43120000
M,11330000,20890000,4273000000,2022,32220000
F,34320000,1950000,4280000000,2020,36270000
F,38170000,29250000,4279000000,2021,67420000
M,1330000,1130000,4111100000,2021,2460000
F,3090000,750000,4211000000,2024,3840000
F,10240000,24400000,4146510700,2023,34640000
M,23630000,13390000,4399000000,2023,37020000
M,18290000,18540000,GANGWON,2021,36830000
M,44270000,19730000,4280000000,2020,64000000
F,1400000,27870000,4111100000,2021,29270000
F,45360000,17010000,GANGWON,2021,62370000
F,49680000,13960000,4291000000,2023,63640000
M,34780000,12870000,4279000000,2022,47650000
M,48200000,12480000,4280000000,2020,60680000
F,32460000,21290000,GYEONGGI,2023,53750000
F,14980000,13120000,4399000000,2021,28100000
M,30700000,29740000,4146510700,2022,60440000
M,28610000,12180000,4291000000,2020,40790000
M,47880000,22870000,4279000000,2024,70750000
M,1490000,20540000,4399000000,2020,22030000
F,20750000,2940000,4291000000,2020,23690000
M,19210000,10180000,GYEONGGI,2021,29390000
F,46100000,24930000,GANGWON,2021,71030000
F,10090000,25590000,4146510700,2024,35680000
F,45140000,15900000,4146510700,2024,61040000
M,42290000,1570000,4399000000,2024,43860000
M,45140000,27100000,4111100000,2023,72240000
M,37390000,9890000,4399000000,2023,47280000
M,17940000,24790000,4291000000,2021,42730000
F,17450000,13830000,4111100000,2021,31280000
M,33040000,2740000,4146510700,2024,35780000
M,49840000,9880000,4211000000,2023,59720000
F,2010000,20110000,4146510700,2022,22120000
M,29800000,3750000,4399000000,2023,33550000
F,20790000,1380000,4291000000,2021,22170000
F,49800000,11510000,4111100000,2023,61310000
F,21670000,7530000,4279000000,2021,29200000
F,49760000,19830000,4111100000,2024,69590000
F,37200000,23500000,GYEONGGI,2024,60700000
F,38160000,7770000,4273000000,2024,45930000
F,5840000,11550000,4273000000,2022,17390000
F,32220000,2810000,4280000000,2022,35030000
M,29070000,24640000,GANGWON,2021,53710000
M,45030000,16500000,4280000000,2020,61530000
M,26680000,13920000,4280000000,2022,40600000
M,15070000,29030000,4111100000,2021,44100000
F,43800000,5860000,4291000000,2023,49660000
M,47730000,9850000,4280000000,2024,57580000
F,43400000,8950000,4399000000,2024,52350000
M,17120000,25280000,4111100000,2024,42400000
M,2050000,5530000,4291000000,2021,7580000
M,26600000,6320000,4273000000,2024,32920000
F,24220000,14230000,4211000000,2022,38450000
M,31840000,27290000,4399000000,2023,59130000
F,35920000,17200000,4279000000,2024,53120000
F,18150000,23520000,GANGWON,2021,41670000
M,13920000,3470000,4279000000,2023,17390000
M,23340000,2120000,4291000000,2024,25460000
M,22820000,27840000,GYEONGGI,2020,50660000
F,30010000,28380000,4291000000,2024,58390000
M,32720000,19370000,4211000000,2022,52090000
F,6960000,10400000,4273000000,2023,17360000
F,30850000,7520000,4146510700,2022,38370000
M,42640000,25070000,4291000000,2020,67710000
M,6630000,12350000,4273000000,2020,18980000
F,7650000,18880000,4279000000,2022,26530000
F,17020000,25970000,4291000000,2023,42990000
F,12410000,22220000,4291000000,2020,34630000
M,3820000,12590000,4280000000,2020,16410000
F,18020000,17670000,4279000000,2024,35690000
M,24000000,3760000,GANGWON,2021,27760000
F,4970000,2390000,GANGWON,2020,7360000
F,3040000,14670000,4399000000,2023,17710000
M,23390000,10940000,GYEONGGI,2023,34330000
F,7500000,26230000,4146510700,2024,33730000
M,27710000,27500000,4291000000,2023,55210000
M,26310000,9730000,4291000000,2024,36040000
F,24040000,26160000,4399000000,2020,50200000
M,10230000,2050000,GYEONGGI,2020,12280000
M,36510000,14840000,4279000000,2020,51350000
F,17680000,2700000,4291000000,2020,20380000
M,47660000,14240000,4273000000,2021,61900000
M,43420000,12230000,4111100000,2021,55650000
M,33830000,10560000,GYEONGGI,2020,44390000
F,49900000,28300000,4291000000,2023,78200000
M,26770000,27000000,GYEONGGI,2024,53770000
F,32100000,4270000,GANGWON,2022,36370000
F,13790000,20700000,4146510700,2024,34490000
M,550000,20900000,4291000000,2022,21450000
M,10430000,20110000,4146510700,2022,30540000
M,8490000,28980000,4211000000,2020,37470000
F,35350000,9010000,4111100000,2022,44360000
M,37430000,25070000,4399000000,2020,62500000
M,14620000,10630000,4146510700,2021,25250000
M,48480000,7730000,4291000000,2023,56210000
M,37270000,21130000,4280000000,2022,58400000
M,37940000,2300000,4399000000,2023,40240000
F,2920000,970000,4399000000,2020,3890000
F,44650000,12480000,4279000000,2022,57130000
M,31740000,12860000,4146510700,2024,44600000
M,35500000,8320000,4280000000,2021,43820000
M,970000,7290000,4146510700,2021,8260000
M,43070000,13700000,4279000000,2022,56770000
F,22210000,3920000,4111100000,2021,26130000
M,37450000,11350000,4291000000,2024,48800000
F,41450000,22570000,GANGWON,2023,64020000
F,22830000,29580000,GANGWON,2024,52410000
M,48150000,6530000,4146510700,2021,54680000
F,44580000,19560000,4279000000,2023,64140000
F,5690000,5180000,GYEONGGI,2024,10870000
F,30600000,28220000,4291000000,2020,58820000
F,25860000,2460000,4146510700,2020,28320000
M,9180000,2930000,GYEONGGI,2023,12110000
M,12780000,23440000,4291000000,2023,36220000
F,39790000,7580000,GYEONGGI,2023,47370000
M,6820000,22800000,4399000000,2020,29620000
M,24020000,8970000,4146510700,2024,32990000
M,30320000,6140000,4279000000,2023,36460000
M,48860000,7900000,4291000000,2020,56760000
M,1800000,12220000,GANGWON,2023,14020000
F,47460000,19280000,4146510700,2023,66740000
M,28100000,140000,4291000000,2023,28240000
M,37170000,1640000,4291000000,2020,38810000
M,37150000,12070000,GYEONGGI,2024,49220000
M,33490000,9290000,GYEONGGI,2020,42780000
F,27310000,17660000,4280000000,2020,44970000
F,40070000,15240000,4146510700,2023,55310000
F,14000000,12880000,4211000000,2022,26880000
F,23070000,17330000,4273000000,2022,40400000
M,39560000,13540000,4211000000,2022,53100000
F,27140000,24840000,4291000000,2020,51980000
M,10590000,9090000,4280000000,2023,19680000
M,20860000,15270000,4291000000,2022,36130000
M,8590000,10220000,4211000000,2021,18810000
M,6730000,4370000,4291000000,2021,11100000
M,48850000,7150000,GYEONGGI,2021,56000000
F,27020000,1700000,4146510700,2024,28720000
F,16690000,16240000,GANGWON,2023,32930000
F,14710000,4760000,4211000000,2020,19470000
F,42900000,20150000,4273000000,2020,63050000
M,30670000,17240000,4273000000,2023,47910000
F,6670000,11770000,GYEONGGI,2024,18440000
M,48390000,28380000,4146510700,2023,76770000
F,2750000,21550000,4111100000,2024,24300000
M,24560000,17030000,4111100000,2022,41590000
M,47950000,14260000,4279000000,2022,62210000
F,10470000,25670000,4279000000,2024,36140000
M,39290000,15830000,4211000000,2023,55120000
M,36060000,7600000,GYEONGGI,2022,43660000
F,46600000,23030000,GYEONGGI,2023,69630000
M,950000,4490000,4291000000,2022,5440000
F,23440000,13290000,4273000000,2023,36730000
F,44060000,27250000,4273000000,2023,71310000
F,34520000,15920000,4273000000,2021,50440000
M,49170000,9010000,4280000000,2024,58180000
M,38530000,18740000,4146510700,2020,57270000
M,42870000,2440000,4399000000,2024,45310000
F,44970000,6500000,4291000000,2023,51470000
M,46660000,7130000,4111100000,2023,53790000
F,41130000,3780000,GYEONGGI,2024,44910000
F,10420000,20580000,4111100000,2023,31000000
M,38610000,25960000,4280000000,2022,64570000
F,17970000,29950000,4111100000,2023,47920000
M,38740000,26890000,4273000000,2024,65630000
M,44930000,25590000,GANGWON,2024,70520000
M,21640000,28430000,4291000000,2024,50070000
M,33190000,20810000,GANGWON,2021,54000000
M,45510000,80000,4279000000,2021,45590000
F,10830000,27630000,GANGWON,2021,38460000
F,45210000,18960000,4399000000,2021,64170000
F,30530000,1180000,GYEONGGI,2021,31710000
M,31320000,2240000,4280000000,2021,33560000
M,7960000,19530000,GYEONGGI,2021,27490000
M,44390000,14920000,4399000000,2024,59310000
F,45190000,13960000,GYEONGGI,2020,59150000
M,2480000,9840000,GANGWON,2021,12320000
F,4810000,3460000,4146510700,2024,8270000
F,910000,780000,GYEONGGI,2020,1690000
M,15940000,18670000,4279000000,2021,34610000
M,20420000,2850000,4291000000,2020,23270000
F,5010000,24070000,4291000000,2020,29080000
M,19210000,9740000,4111100000,2022,28950000
F,42040000,7370000,4211000000,2023,49410000
M,10230000,10260000,GANGWON,2022,20490000
M,24560000,18530000,4273000000,2020,43090000
F,30580000,2330000,4399000000,2024,32910000
M,37200000,3480000,4280000000,2021,40680000
F,39080000,18170000,GANGWON,2023,57250000
M,30730000,21010000,4291000000,2021,51740000
F,21220000,22300000,4111100000,2024,43520000
F,24070000,12790000,GYEONGGI,2023,36860000
M,21820000,24290000,4273000000,2022,46110000
F,34500000,15310000,4273000000,2020,49810000
M,29200000,27730000,4211000000,2024,56930000
M,4660000,24450000,4146510700,2020,29110000
M,4510000,2750000,4211000000,2020,7260000
F,23310000,380000,GYEONGGI,2021,23690000
F,10680000,10710000,GANGWON,2024,21390000
M,15800000,25800000,4279000000,2020,41600000
M,1190000,670000,4399000000,2022,1860000
F,9000000,10070000,4273000000,2023,19070000
M,500000,11510000,4280000000,2024,12010000
M,6540000,13010000,GANGWON,2021,19550000
F,44460000,29230000,4280000000,2024,73690000
M,13020000,7790000,4111100000,2021,20810000
F,33010000,400000,4280000000,2023,33410000
M,32830000,6720000,4273000000,2022,39550000
F,38630000,16670000,4273000000,2020,55300000
M,49970000,2090000,4273000000,2024,52060000
M,43590000,19560000,GANGWON,2021,63150000
F,22960000,24620000,GANGWON,2023,47580000
M,3840000,22350000,4399000000,2020,26190000
F,3920000,9340000,4291000000,2023,13260000
M,36780000,11900000,4146510700,2022,48680000
F,21720000,25900000,GYEONGGI,2020,47620000
F,37840000,15140000,GYEONGGI,2020,52980000
F,12130000,25040000,4111100000,2020,37170000
F,29320000,4850000,4211000000,2021,34170000
M,27070000,4460000,4399000000,2020,31530000
M,28900000,7740000,4291000000,2023,36640000
F,20580000,23520000,4279000000,2021,44100000
F,18250000,29070000,4111100000,2020,47320000
F,18340000,14850000,GANGWON,2023,33190000
M,3070000,15550000,4291000000,2023,18620000
M,43480000,17190000,4273000000,2024,60670000
M,29990000,6480000,GANGWON,2023,36470000
M,13320000,24360000,4211000000,2022,37680000
F,38800000,14390000,4211000000,2020,53190000
F,27080000,8310000,GYEONGGI,2020,35390000
F,17720000,11560000,4146510700,2020,29280000
M,31200000,7600000,4146510700,2023,38800000
M,39300000,16930000,4279000000,2023,56230000
M,34670000,25830000,GANGWON,2020,60500000
F,36550000,24980000,GANGWON,2021,61530000
F,2290000,3210000,4211000000,2021,5500000
M,48340000,1650000,4273000000,2022,49990000
F,23870000,1270000,4273000000,2024,25140000
M,41970000,2360000,4280000000,2022,44330000
M,38150000,770000,4273000000,2020,38920000
F,7170000,6690000,4291000000,2020,13860000
M,32380000,20680000,4146510700,2020,53060000
F,34530000,15260000,4273000000,2024,49790000
M,10440000,12870000,4399000000,2023,23310000
F,17190000,29150000,GANGWON,2024,46340000
F,27800000,15590000,4273000000,2022,43390000
F,7040000,1460000,4280000000,2023,8500000
M,20210000,3340000,4279000000,2023,23550000
M,12500000,15460000,4279000000,2022,27960000
F,13120000,9710000,4211000000,2023,22830000
F,24290000,29850000,4273000000,2021,54140000
M,18320000,10530000,GANGWON,2022,28850000
M,2950000,7750000,GANGWON,2022,10700000
M,18000000,22350000,4146510700,2021,40350000
F,13620000,28100000,4279000000,2024,41720000
M,47700000,18350000,4211000000,2024,66050000
M,28530000,16650000,4273000000,2024,45180000
F,1540000,980000,4279000000,2023,2520000
M,32270000,18810000,4279000000,2021,51080000
M,14530000,14530000,GANGWON,2022,29060000
M,15590000,3520000,4273000000,2022,19110000
F,41380000,4280000,4111100000,2022,45660000
F,23610000,23170000,4273000000,2023,46780000
F,34410000,1060000,4291000000,2023,35470000
F,31350000,24760000,4279000000,2024,56110000
F,41500000,23960000,4146510700,2023,65460000
F,33550000,6700000,4111100000,2024,40250000
F,46980000,8340000,4280000000,2024,55320000
M,23840000,19530000,4211000000,2022,43370000
M,32540000,23710000,4273000000,2023,56250000
F,32130000,7380000,4146510700,2024,39510000
M,4470000,16860000,4280000000,2021,21330000
M,8650000,2160000,4280000000,2021,10810000
F,47640000,350000,4279000000,2023,47990000
M,8790000,6720000,4291000000,2022,15510000
M,6870000,20230000,4279000000,2022,27100000
M,49430000,16720000,4211000000,2024,66150000
M,39690000,12510000,4111100000,2023,52200000
M,48290000,20870000,GANGWON,2021,69160000
F,15110000,980000,4399000000,2024,16090000
F,40120000,7070000,4111100000,2024,47190000
F,1380000,26140000,4211000000,2020,27520000
M,1940000,20570000,GANGWON,2023,22510000
F,43070000,860000,4280000000,2024,43930000
M,7500000,15470000,4111100000,2021,22970000
M,25490000,10070000,GANGWON,2020,35560000
M,33470000,17840000,4273000000,2021,51310000
M,17020000,26270000,4279000000,2022,43290000
F,20120000,17010000,4399000000,2020,37130000
F,17690000,460000,4146510700,2020,18150000
M,1760000,670000,4273000000,2024,2430000
F,48370000,21040000,4111100000,2022,69410000
M,28410000,7530000,GYEONGGI,2024,35940000
F,27370000,12490000,GANGWON,2023,39860000
F,43410000,5470000,4280000000,2021,48880000
M,24330000,15250000,4280000000,2021,39580000
F,48900000,14030000,GYEONGGI,2024,62930000
M,8380000,1600000,4111100000,2021,9980000
F,1850000,28440000,4280000000,2021,30290000
M,21750000,13150000,4291000000,2023,34900000
M,26580000,14530000,4280000000,2022,41110000
F,4970000,17580000,4399000000,2020,22550000
F,47990000,6630000,4291000000,2024,54620000
M,1420000,20900000,4211000000,2024,22320000
F,21960000,22000000,4211000000,2023,43960000
F,2120000,27600000,GANGWON,2023,29720000
M,17290000,7920000,4291000000,2020,25210000
M,6270000,28800000,4273000000,2022,35070000
F,27660000,2150000,GANGWON,2024,29810000
M,40460000,5770000,4273000000,2023,46230000
M,29800000,11980000,4399000000,2024,41780000
M,25650000,5290000,4279000000,2021,30940000
F,33990000,26190000,4111100000,2024,60180000
F,13650000,2780000,4291000000,2022,16430000
M,12000000,15620000,GYEONGGI,2022,27620000
F,12990000,8370000,4146510700,2024,21360000
M,34810000,28240000,4111100000,2021,63050000
F,6760000,8840000,4399000000,2022,15600000
M,15550000,25980000,4291000000,2023,41530000
M,31940000,16340000,4211000000,2024,48280000
F,47640000,21630000,4111100000,2021,69270000
M,49730000,15720000,4273000000,2023,65450000
F,39310000,4910000,GYEONGGI,2024,44220000
F,1890000,8120000,4111100000,2021,10010000
M,13100000,19850000,4146510700,2023,32950000
M,13730000,10530000,4399000000,2022,24260000
F,22630000,140000,4399000000,2024,22770000
M,41150000,10720000,GANGWON,2024,51870000
M,24760000,20940000,4399000000,2022,45700000
M,940000,15770000,GANGWON,2020,16710000
M,28950000,13690000,4399000000,2023,42640000
M,15940000,17290000,4146510700,2022,33230000
F,39890000,28930000,4399000000,2024,68820000
F,19890000,18860000,GYEONGGI,2023,38750000
M,41300000,8900000,4279000000,2023,50200000
M,14050000,20060000,4211000000,2020,34110000
M,15620000,24190000,GYEONGGI,2024,39810000
F,44180000,11090000,4399000000,2021,55270000
M,12610000,11030000,4291000000,2020,23640000
F,30720000,13880000,4273000000,2020,44600000
F,16130000,24860000,4279000000,2021,40990000
F,19390000,2410000,4211000000,2021,21800000
M,28310000,28240000,4273000000,2020,56550000
F,22920000,22020000,GYEONGGI,2023,44940000
M,19210000,7240000,4146510700,2022,26450000
F,37780000,25690000,4146510700,2022,63470000
M,5440000,15880000,4273000000,2020,21320000
F,1990000,14670000,4291000000,2023,16660000
M,39410000,7190000,4273000000,2021,46600000
F,29970000,4380000,GYEONGGI,2020,34350000
M,21480000,29700000,4273000000,2024,51180000
M,45510000,1120000,4211000000,2023,46630000
M,35040000,24900000,4291000000,2024,59940000
M,36650000,18970000,4280000000,2024,55620000
F,42810000,23010000,4111100000,2020,65820000
F,32930000,1170000,4280000000,2023,34100000
M,45590000,18160000,GANGWON,2024,63750000
F,26630000,2510000,4273000000,2023,29140000
M,1530000,6600000,4146510700,2022,8130000
M,35850000,28150000,4280000000,2024,64000000
F,12610000,17630000,4399000000,2024,30240000
M,20970000,5200000,GYEONGGI,2023,26170000
M,31040000,26830000,4280000000,2022,57870000
F,48280000,27420000,4279000000,2024,75700000
M,4100000,8240000,4291000000,2020,12340000
M,28560000,1870000,GYEONGGI,2023,30430000
M,18580000,7900000,4146510700,2023,26480000
M,3980000,27870000,GANGWON,2024,31850000
F,39910000,910000,4280000000,2022,40820000
F,41960000,19780000,4291000000,2024,61740000
F,21710000,26670000,4111100000,2021,48380000
M,9620000,25180000,4291000000,2024,34800000
M,37390000,10920000,4291000000,2021,48310000
F,6090000,29660000,GYEONGGI,2020,35750000
M,17810000,2030000,4111100000,2023,19840000
M,23960000,6490000,4291000000,2023,30450000
M,10770000,7220000,4279000000,2022,17990000
M,4100000,6350000,4280000000,2024,10450000
F,21020000,23750000,4280000000,2020,44770000
F,20090000,29230000,4279000000,2021,49320000
F,27750000,20060000,4280000000,2022,47810000
M,26710000,22420000,4291000000,2020,49130000
F,49690000,5190000,GANGWON,2020,54880000
F,42720000,9650000,4291000000,2021,52370000
M,9100000,26480000,GYEONGGI,2021,35580000
M,24060000,24040000,4399000000,2023,48100000
F,270000,12730000,GANGWON,2024,13000000
F,28440000,1850000,4146510700,2022,30290000
F,31700000,27410000,4146510700,2024,59110000
F,32690000,370000,GANGWON,2022,33060000
M,27040000,14500000,4291000000,2020,41540000
F,48010000,29830000,4273000000,2021,77840000
F,22690000,13760000,4399000000,2021,36450000
M,10110000,12820000,4279000000,2020,22930000
F,24650000,21230000,4291000000,2020,45880000
M,19800000,6320000,GANGWON,2022,26120000
M,20750000,8620000,4273000000,2020,29370000
M,700000,27190000,4291000000,2022,27890000
F,5100000,17140000,4273000000,2024,22240000
F,23810000,23530000,GANGWON,2021,47340000
M,15240000,440000,4291000000,2021,15680000
F,3900000,19430000,4111100000,2021,23330000
F,33680000,5240000,4280000000,2024,38920000
M,29760000,5770000,GANGWON,2024,35530000
M,41850000,27040000,4146510700,2023,68890000
F,11050000,22420000,4146510700,2022,33470000
M,23650000,23730000,4399000000,2022,47380000
F,28980000,11290000,4211000000,2023,40270000
F,14830000,10460000,4146510700,2021,25290000
F,13490000,26630000,4211000000,2022,40120000
F,34420000,25980000,4111100000,2022,60400000
M,10170000,18710000,GANGWON,2021,28880000
M,14850000,28170000,4273000000,2020,43020000
M,1740000,11070000,4399000000,2020,12810000
M,17810000,11320000,4280000000,2023,29130000
F,18230000,8090000,4279000000,2024,26320000
F,27740000,24080000,4211000000,2022,51820000
M,41180000,10070000,4280000000,2022,51250000
F,21830000,24640000,4399000000,2023,46470000
F,42430000,23480000,4399000000,2023,65910000
F,43390000,820000,4146510700,2022,44210000
M,2870000,12680000,4280000000,2021,15550000
M,19040000,20410000,4291000000,2021,39450000
M,22790000,27650000,GYEONGGI,2024,50440000
F,13850000,11890000,4399000000,2022,25740000
M,26860000,29120000,4211000000,2022,55980000
M,14220000,24240000,4279000000,2022,38460000
M,1550000,8160000,4279000000,2022,9710000
M,47080000,14040000,4111100000,2023,61120000
M,31770000,20390000,4111100000,2020,52160000
M,49060000,2500000,4146510700,2022,51560000
F,34150000,13830000,4291000000,2020,47980000
F,12140000,3930000,4146510700,2021,16070000
M,5900000,13440000,4279000000,2024,19340000
M,29080000,4050000,4273000000,2021,33130000
F,5820000,28920000,4279000000,2022,34740000
F,230000,22650000,4399000000,2021,22880000
M,21800000,2190000,4280000000,2023,23990000
M,12530000,2420000,4280000000,2020,14950000
M,850000,22360000,4399000000,2022,23210000
M,32920000,9010000,4399000000,2023,41930000
F,30640000,16060000,4279000000,2020,46700000
M,21550000,26690000,4280000000,2023,48240000
M,9090000,4090000,4280000000,2021,13180000
M,31200000,24330000,GANGWON,2022,55530000
M,35190000,6010000,4280000000,2021,41200000
F,43400000,10460000,4399000000,2024,53860000
F,7870000,11770000,4111100000,2022,19640000
F,8710000,20270000,4291000000,2021,28980000
M,32790000,11100000,4273000000,2022,43890000
M,1800000,29230000,4399000000,2020,31030000
F,12210000,7870000,4280000000,2022,20080000
M,2380000,2600000,4211000000,2022,4980000
M,460000,13730000,4279000000,2020,14190000
F,47370000,390000,4279000000,2021,47760000
F,3710000,29280000,4291000000,2022,32990000
F,42500000,9710000,4399000000,2023,52210000
F,4300000,22850000,4291000000,2022,27150000
M,38300000,21970000,4111100000,2021,60270000
M,23000000,10240000,GYEONGGI,2020,33240000
F,15530000,20320000,4146510700,2021,35850000
M,43580000,8020000,4211000000,2024,51600000
F,22450000,14640000,4146510700,2022,37090000
F,8000000,7860000,GYEONGGI,2022,15860000
M,5100000,2790000,4211000000,2020,7890000
F,22540000,14920000,4146510700,2022,37460000
M,43940000,22570000,4211000000,2023,66510000
M,17690000,170000,4291000000,2023,17860000
M,47570000,22340000,4273000000,2021,69910000
M,6370000,10800000,GANGWON,2020,17170000
F,24850000,15180000,4211000000,2024,40030000
M,44870000,12290000,GYEONGGI,2021,57160000
F,31040000,16840000,4291000000,2020,47880000
F,23260000,80000,GANGWON,2020,23340000
F,2570000,7390000,4291000000,2021,9960000
F,28570000,2690000,4111100000,2021,31260000
M,35980000,19710000,4280000000,2022,55690000
M,47040000,9260000,4279000000,2024,56300000
F,38870000,23560000,4111100000,2023,62430000
F,45140000,14950000,GYEONGGI,2022,60090000
M,27440000,20540000,4399000000,2020,47980000
F,47080000,29010000,4399000000,2024,76090000
M,1310000,20970000,4279000000,2024,22280000
F,19140000,4080000,4291000000,2021,23220000
M,43380000,9400000,4273000000,2024,52780000
F,22540000,16760000,GYEONGGI,2024,39300000
F,5050000,1410000,4279000000,2020,6460000
M,37620000,5350000,GANGWON,2022,42970000
F,10200000,1260000,GANGWON,2024,11460000
F,18860000,29230000,4399000000,2021,48090000
M,12010000,25550000,4280000000,2022,37560000
F,3680000,19340000,4291000000,2021,23020000
M,5990000,19020000,4399000000,2024,25010000
M,34420000,6190000,4273000000,2022,40610000
F,14430000,12410000,4279000000,2024,26840000
F,38190000,27440000,4211000000,2020,65630000
F,40180000,3120000,4273000000,2022,43300000
F,42560000,5610000,4211000000,2021,48170000
F,46010000,11690000,4291000000,2020,57700000
F,5880000,22920000,4279000000,2023,28800000
F,46050000,27870000,GANGWON,2021,73920000
M,40900000,23080000,GANGWON,2024,63980000
F,13950000,7730000,4111100000,2021,21680000
M,17800000,9850000,GANGWON,2023,27650000
F,3820000,16410000,GYEONGGI,2021,20230000
F,41280000,23390000,4111100000,2020,64670000
M,7530000,9060000,4111100000,2021,16590000
F,11360000,310000,GANGWON,2022,11670000
F,19100000,24330000,4399000000,2023,43430000
M,27170000,25650000,4280000000,2021,52820000
F,46420000,19800000,4280000000,2023,66220000
F,7190000,21620000,GYEONGGI,2020,28810000
F,2800000,610000,4146510700,2022,3410000
M,48500000,4530000,4399000000,2024,53030000
F,28050000,6920000,4146510700,2021,34970000
F,48720000,18180000,4211000000,2020,66900000
F,28510000,13720000,4399000000,2023,42230000
F,10000000,26370000,4279000000,2023,36370000
M,6570000,3450000,4146510700,2020,10020000
M,1140000,9120000,GYEONGGI,2021,10260000
F,49060000,17910000,GYEONGGI,2024,66970000
F,22320000,27810000,4399000000,2021,50130000
M,32050000,24880000,4111100000,2022,56930000
M,32080000,24500000,4279000000,2021,56580000
F,110000,9070000,4291000000,2022,9180000
M,7530000,21330000,4279000000,2023,28860000
F,11630000,19060000,GYEONGGI,2022,30690000
M,47250000,25030000,4211000000,2024,72280000
M,37830000,15310000,4146510700,2020,53140000
M,30770000,26930000,4146510700,2022,57700000
M,43850000,19120000,4211000000,2021,62970000
F,2430000,3410000,4273000000,2022,5840000
M,18960000,21590000,4399000000,2023,40550000
M,11370000,13530000,GYEONGGI,2022,24900000
F,16190000,3340000,4280000000,2024,19530000
M,19590000,25500000,GANGWON,2022,45090000
M,9380000,11480000,4211000000,2024,20860000
F,27630000,13030000,4211000000,2021,40660000
M,29590000,3200000,4279000000,2023,32790000
F,45420000,16390000,4399000000,2020,61810000
F,25240000,21820000,4399000000,2021,47060000
F,12410000,8430000,4280000000,2021,20840000
F,44770000,22220000,GANGWON,2020,66990000
M,34830000,20840000,4399000000,2022,55670000
F,13570000,10560000,4111100000,2022,24130000
M,4110000,15930000,GYEONGGI,2022,20040000
M,16420000,17010000,4111100000,2023,33430000
M,3450000,9000000,4273000000,2021,12450000
M,31090000,21010000,GYEONGGI,2024,52100000
M,21460000,12930000,4291000000,2020,34390000
M,29790000,9050000,GYEONGGI,2021,38840000
M,10840000,18570000,GYEONGGI,2022,29410000
M,5680000,25420000,4280000000,2020,31100000
M,25660000,11820000,4111100000,2024,37480000
M,45440000,22580000,GANGWON,2021,68020000
F,34320000,7590000,4279000000,2021,41910000
F,24710000,19190000,4280000000,2023,43900000
F,18700000,17040000,GYEONGGI,2021,35740000
M,42320000,20200000,4279000000,2021,62520000
F,34040000,1770000,4146510700,2024,35810000
F,5470000,21430000,4279000000,2024,26900000
F,14460000,20600000,4211000000,2020,35060000
M,5670000,27810000,4280000000,2022,33480000
M,15720000,8750000,4280000000,2024,24470000
M,18400000,10300000,4211000000,2020,28700000
M,39650000,16790000,4146510700,2021,56440000
F,2910000,8940000,4399000000,2020,11850000
F,27950000,12160000,4399000000,2020,40110000
F,47480000,9920000,4399000000,2020,57400000
F,19020000,21670000,4399000000,2020,40690000
M,40140000,5580000,4111100000,2024,45720000
M,16030000,20770000,4211000000,2022,36800000
M,49550000,16680000,4146510700,2020,66230000
F,13320000,21450000,GYEONGGI,2023,34770000
M,33850000,6940000,4273000000,2021,40790000
M,11760000,8540000,4280000000,2021,20300000
F,25110000,2090000,4279000000,2021,27200000
F,33310000,19670000,4399000000,2021,52980000
M,9520000,2720000,4279000000,2021,12240000
M,37430000,10080000,4273000000,2020,47510000
M,7030000,20070000,4280000000,2022,27100000
M,2110000,1770000,4291000000,2023,3880000
M,6960000,20390000,GANGWON,2024,27350000
M,34890000,5490000,4146510700,2023,40380000
F,20400000,22880000,4111100000,2024,43280000
F,5990000,19920000,4279000000,2024,25910000
F,19630000,10780000,4399000000,2023,30410000
M,6300000,7330000,4211000000,2020,13630000
F,37150000,19100000,4279000000,2021,56250000
M,3300000,12290000,4280000000,2020,15590000
M,25610000,27100000,4291000000,2021,52710000
F,2080000,26500000,4146510700,2022,28580000
M,46770000,23720000,4211000000,2024,70490000
M,30690000,13670000,GANGWON,2023,44360000
F,32880000,20910000,4280000000,2022,53790000
F,10980000,21060000,4291000000,2021,32040000
F,41150000,10420000,4211000000,2020,51570000
M,23700000,20780000,GANGWON,2023,44480000
F,14090000,12000000,4279000000,2024,26090000
F,29810000,17260000,4280000000,2022,47070000
M,31220000,5310000,GYEONGGI,2024,36530000
F,23530000,7960000,GANGWON,2021,31490000
F,27960000,12940000,4291000000,2024,40900000
F,15740000,22760000,GYEONGGI,2020,38500000
M,23830000,23210000,GYEONGGI,2022,47040000
M,15160000,7180000,4111100000,2022,22340000
M,39670000,4200000,4291000000,2020,43870000
M,39120000,24910000,GYEONGGI,2024,64030000
F,40470000,12380000,4279000000,2020,52850000
M,41310000,15620000,4280000000,2023,56930000
M,6660000,16640000,4280000000,2020,23300000
F,210000,4150000,4279000000,2024,4360000
F,5720000,2600000,4111100000,2020,8320000
F,48380000,16890000,4146510700,2021,65270000
M,17520000,28880000,4111100000,2020,46400000
M,35930000,6380000,4280000000,2020,42310000
M,49890000,2350000,4146510700,2024,52240000
F,44010000,7030000,4111100000,2023,51040000
F,48660000,8160000,GYEONGGI,2023,56820000
M,15210000,28530000,4146510700,2024,43740000
F,8970000,15380000,4280000000,2024,24350000
F,28450000,3610000,4279000000,2024,32060000
F,20650000,16370000,4399000000,2021,37020000
M,21680000,27390000,GYEONGGI,2022,49070000
F,18720000,2860000,GYEONGGI,2020,21580000
F,43980000,27930000,4399000000,2024,71910000
M,41490000,26910000,GANGWON,2024,68400000
M,25240000,22120000,4273000000,2024,47360000
F,42320000,1650000,4211000000,2023,43970000
F,27180000,5400000,4291000000,2024,32580000
M,20150000,5240000,4111100000,2020,25390000
M,28610000,6060000,4273000000,2024,34670000
F,28690000,14600000,4111100000,2020,43290000
F,1570000,24740000,4273000000,2021,26310000
F,43960000,9550000,4146510700,2022,53510000
F,10710000,17680000,4279000000,2023,28390000
M,44170000,2710000,4291000000,2020,46880000
F,26790000,5820000,4291000000,2021,32610000
F,13400000,11380000,4111100000,2022,24780000
M,13460000,1920000,4399000000,2022,15380000
F,24620000,20400000,4146510700,2022,45020000
M,7000000,29200000,GANGWON,2020,36200000
F,3490000,8910000,4291000000,2021,12400000
F,2840000,790000,4211000000,2024,3630000
M,22750000,19880000,4111100000,2021,42630000
M,24840000,22110000,GYEONGGI,2021,46950000
F,47450000,29070000,4211000000,2021,76520000
F,46660000,18340000,4280000000,2020,65000000
F,31440000,3000000,4111100000,2020,34440000
M,27680000,16820000,4111100000,2020,44500000
F,41880000,2470000,GYEONGGI,2021,44350000
M,2020000,5250000,4146510700,2020,7270000
M,6420000,23180000,GYEONGGI,2022,29600000
F,29010000,25420000,4291000000,2020,54430000
M,47200000,23500000,4279000000,2023,70700000
F,37080000,5510000,4111100000,2020,42590000
F,24110000,8210000,4280000000,2020,32320000
F,28090000,4180000,4399000000,2020,32270000
F,30090000,13700000,4111100000,2020,43790000
F,6280000,24820000,GYEONGGI,2023,31100000
M,31460000,12140000,4273000000,2024,43600000
M,42290000,9390000,4111100000,2020,51680000
F,48440000,14700000,4111100000,2022,63140000
F,39570000,12460000,4280000000,2023,52030000
M,29990000,4170000,4280000000,2024,34160000
M,6510000,23190000,4111100000,2020,29700000
M,8130000,27100000,4273000000,2024,35230000
M,21580000,22130000,4279000000,2022,43710000
F,9490000,2570000,GANGWON,2023,12060000
F,24320000,4190000,4273000000,2023,28510000
M,5050000,10320000,4273000000,2024,15370000
F,29590000,14470000,4273000000,2020,44060000
M,16610000,3300000,4279000000,2021,19910000
F,31840000,23780000,4146510700,2023,55620000
M,22830000,18240000,4146510700,2021,41070000
F,21070000,17490000,4273000000,2023,38560000
M,23280000,15050000,GANGWON,2020,38330000
M,30270000,11320000,GYEONGGI,2020,41590000
F,17320000,19710000,4211000000,2023,37030000
M,37490000,24540000,4146510700,2024,62030000
F,12690000,21260000,4399000000,2020,33950000
F,29540000,6850000,4280000000,2020,36390000
M,39790000,23350000,4279000000,2022,63140000
F,40030000,11040000,4279000000,2020,51070000
F,23990000,9840000,4211000000,2022,33830000
F,31230000,19470000,4146510700,2020,50700000
F,21240000,29360000,GANGWON,2020,50600000
F,41170000,25780000,GANGWON,2024,66950000
M,21200000,4000000,4280000000,2024,25200000
F,32050000,3510000,4273000000,2020,35560000
F,12560000,8200000,GYEONGGI,2023,20760000
F,5910000,28080000,4146510700,2023,33990000
F,8510000,17410000,GANGWON,2020,25920000
F,15270000,6430000,4211000000,2023,21700000
M,25800000,19100000,4280000000,2020,44900000
F,10980000,17320000,4111100000,2024,28300000
M,13350000,12880000,4280000000,2021,26230000
M,47080000,22280000,GANGWON,2022,69360000
M,11680000,390000,4111100000,2023,12070000
M,43150000,5970000,4399000000,2023,49120000
F,34710000,3750000,4291000000,2024,38460000
M,16150000,12920000,4280000000,2023,29070000
M,12120000,7070000,4211000000,2020,19190000
F,42920000,3300000,4211000000,2020,46220000
F,45160000,4950000,GYEONGGI,2021,50110000
F,6300000,6530000,4273000000,2021,12830000
M,2360000,14800000,4280000000,2021,17160000
F,6190000,25920000,GANGWON,2020,32110000
F,880000,1750000,4291000000,2021,2630000
M,32420000,22990000,4146510700,2021,55410000
F,28750000,1220000,GANGWON,2020,29970000
F,44140000,5240000,4211000000,2024,49380000
F,36260000,5000000,4399000000,2023,41260000
F,13170000,14770000,GANGWON,2022,27940000
M,10010000,19670000,4279000000,2020,29680000
F,31080000,14730000,4211000000,2020,45810000
F,35020000,13930000,4280000000,2022,48950000
M,23530000,6820000,4399000000,2022,30350000
F,30950000,600000,4279000000,2021,31550000
M,48880000,5550000,4111100000,2022,54430000
F,890000,27260000,4291000000,2023,28150000
M,10350000,5570000,4211000000,2023,15920000
M,14130000,18470000,4280000000,2023,32600000
M,41570000,970000,4279000000,2023,42540000
M,36420000,29160000,4279000000,2023,65580000
F,17630000,14430000,4273000000,2021,32060000
M,32280000,21980000,4279000000,2020,54260000
F,3350000,25480000,4291000000,2022,28830000
M,33330000,20030000,4399000000,2020,53360000
M,19780000,19650000,4399000000,2022,39430000
M,38190000,20400000,4279000000,2021,58590000
F,22150000,4970000,4280000000,2021,27120000
M,46430000,6840000,4211000000,2024,53270000
F,19790000,9420000,4280000000,2024,29210000
F,16910000,17250000,GYEONGGI,2021,34160000
F,17630000,5320000,4211000000,2021,22950000
F,45970000,4740000,4111100000,2022,50710000
F,21410000,6680000,4291000000,2021,28090000
F,46620000,24680000,4280000000,2020,71300000
F,9300000,25550000,4273000000,2022,34850000
F,40080000,29440000,4399000000,2021,69520000
F,29860000,3610000,4279000000,2022,33470000
M,49690000,25340000,4211000000,2022,75030000
M,32320000,9460000,4279000000,2023,41780000
M,20330000,2150000,4111100000,2024,22480000
M,21780000,14130000,GYEONGGI,2022,35910000
M,4710000,17720000,4279000000,2022,22430000
F,9660000,11790000,4280000000,2023,21450000
F,19290000,15330000,4211000000,2021,34620000
F,5120000,9430000,4273000000,2022,14550000
F,32500000,29660000,4111100000,2023,62160000
F,10590000,28990000,GANGWON,2020,39580000
F,17560000,5860000,4291000000,2023,23420000
F,4470000,10210000,GYEONGGI,2024,14680000
M,18520000,15170000,4280000000,2024,33690000
M,40860000,27130000,4291000000,2021,67990000
M,2780000,18490000,4273000000,2021,21270000
M,35400000,29720000,4291000000,2024,65120000
F,23510000,29870000,4399000000,2024,53380000
F,3500000,3290000,4211000000,2022,6790000
F,26800000,5870000,4291000000,2024,32670000
M,7180000,28790000,4280000000,2021,35970000
F,41530000,27300000,GANGWON,2024,68830000
F,2260000,28730000,4399000000,2021,30990000
F,4180000,25000000,4399000000,2020,29180000
M,3430000,300000,4291000000,2024,3730000
F,40190000,29140000,GYEONGGI,2021,69330000
M,24460000,3110000,4146510700,2023,27570000
M,16180000,1450000,GYEONGGI,2022,17630000
M,15820000,16680000,4279000000,2021,32500000
M,14920000,12080000,4280000000,2024,27000000
F,27170000,29330000,4146510700,2024,56500000
M,25290000,21490000,4211000000,2020,46780000
M,49920000,28250000,4399000000,2023,78170000
F,19370000,9100000,4280000000,2021,28470000
F,34190000,9360000,4273000000,2023,43550000
M,20630000,15880000,4279000000,2020,36510000
F,33370000,6420000,GANGWON,2022,39790000
M,21710000,9380000,4279000000,2023,31090000
M,19730000,19010000,4280000000,2020,38740000
M,12270000,25160000,4211000000,2021,37430000
M,5420000,2650000,4399000000,2022,8070000
F,30570000,5390000,4111100000,2024,35960000
M,47460000,28190000,4111100000,2020,75650000
F,46400000,26870000,4280000000,2024,73270000
F,35200000,26540000,4291000000,2022,61740000
F,36930000,8320000,GYEONGGI,2020,45250000
F,22580000,9490000,4279000000,2020,32070000
M,30360000,6660000,4211000000,2022,37020000
F,13670000,660000,4279000000,2021,14330000
M,8820000,5440000,4273000000,2020,14260000
F,37960000,17560000,4111100000,2022,55520000
F,21090000,14520000,4399000000,2023,35610000
M,230000,25670000,4273000000,2024,25900000
M,44820000,26140000,4399000000,2020,70960000
M,25480000,7800000,4279000000,2023,33280000
F,28180000,20860000,4211000000,2020,49040000
F,27770000,19240000,4111100000,2021,47010000
M,28520000,7100000,4279000000,2022,35620000
M,13690000,10920000,4111100000,2020,24610000
M,10680000,20570000,4280000000,2022,31250000
M,46370000,3190000,GANGWON,2020,49560000
F,25730000,5470000,GANGWON,2021,31200000
M,49520000,13110000,4399000000,2021,62630000
M,47770000,16410000,4279000000,2023,64180000
M,41270000,18680000,4146510700,2021,59950000
M,1090000,9010000,4111100000,2022,10100000
F,25760000,18580000,4111100000,2021,44340000
M,43510000,25510000,4146510700,2020,69020000
F,27530000,26330000,4291000000,2021,53860000
M,4810000,21530000,4279000000,2022,26340000
M,45860000,10870000,4146510700,2020,56730000
F,4850000,5750000,GANGWON,2023,10600000
M,39800000,29890000,4111100000,2023,69690000
F,31450000,8460000,GANGWON,2023,39910000
F,1380000,14050000,4279000000,2020,15430000
M,34060000,27030000,4211000000,2023,61090000
F,6050000,9950000,4211000000,2021,16000000
F,29400000,21360000,4399000000,2020,50760000
F,6430000,19620000,GANGWON,2020,26050000
F,21340000,13920000,GANGWON,2020,35260000
F,680000,26480000,GANGWON,2024,27160000
F,42360000,12760000,4291000000,2022,55120000
F,10310000,6770000,GANGWON,2024,17080000
F,17110000,9580000,4211000000,2024,26690000
M,26740000,17620000,4291000000,2024,44360000
M,49940000,720000,4399000000,2022,50660000
F,4770000,12370000,4280000000,2024,17140000
M,25550000,20100000,4273000000,2023,45650000
F,22470000,18390000,4399000000,2020,40860000
F,49030000,18220000,GYEONGGI,2020,67250000
M,20470000,1500000,4291000000,2021,21970000
F,29990000,13770000,4211000000,2023,43760000
F,14690000,19600000,4211000000,2022,34290000
F,34130000,17970000,4279000000,2020,52100000
F,4210000,11930000,4111100000,2024,16140000
M,23740000,6690000,GANGWON,2021,30430000
F,25060000,390000,4211000000,2021,25450000
F,32680000,14460000,GANGWON,2020,47140000
F,46880000,13650000,4146510700,2023,60530000
M,16270000,1880000,4111100000,2021,18150000
F,40700000,4690000,4146510700,2020,45390000
M,11520000,21860000,GANGWON,2023,33380000
M,23700000,17000000,4291000000,2020,40700000
F,9320000,4990000,GYEONGGI,2020,14310000
F,30710000,11260000,4111100000,2023,41970000
M,10540000,4120000,4291000000,2023,14660000
F,2900000,15900000,4211000000,2023,18800000
M,37080000,14290000,GYEONGGI,2020,51370000
M,22910000,12490000,4280000000,2021,35400000
F,39240000,15410000,4211000000,2022,54650000
F,28410000,11130000,4273000000,2022,39540000
M,47870000,9820000,4399000000,2020,57690000
M,120000,23270000,4111100000,2020,23390000
M,29730000,290000,4273000000,2021,30020000
M,1760000,14370000,GANGWON,2023,16130000
F,16950000,7590000,4111100000,2020,24540000
F,28050000,24610000,4399000000,2024,52660000
F,8200000,19650000,4111100000,2023,27850000
F,32670000,4720000,4291000000,2020,37390000
F,19900000,9970000,4146510700,2024,29870000
M,29010000,21740000,4279000000,2021,50750000
F,42530000,11370000,4291000000,2024,53900000
F,40600000,26340000,4399000000,2020,66940000
F,2410000,1240000,4111100000,2022,3650000
F,4290000,29750000,4291000000,2020,34040000
F,45800000,4690000,4146510700,2022,50490000
M,140000,22130000,4273000000,2021,22270000
M,5740000,22070000,4291000000,2021,27810000
M,11380000,11700000,GANGWON,2023,23080000
F,18590000,110000,4273000000,2023,18700000
M,30020000,2340000,4399000000,2022,32360000
M,43660000,11760000,4273000000,2022,55420000
F,8490000,5840000,4111100000,2021,14330000
F,22310000,23570000,GYEONGGI,2024,45880000
F,10420000,850000,GYEONGGI,2022,11270000
M,21440000,9230000,4280000000,2022,30670000
M,2360000,12330000,GANGWON,2024,14690000
F,7280000,5360000,4111100000,2023,12640000
F,35960000,9020000,4399000000,2023,44980000
M,48020000,25400000,4211000000,2022,73420000
M,14340000,6610000,GYEONGGI,2023,20950000
F,49340000,10540000,4399000000,2023,59880000
F,43680000,26760000,4273000000,2023,70440000
M,19820000,8120000,4291000000,2021,27940000
F,44720000,24990000,GYEONGGI,2020,69710000
M,17550000,12890000,4111100000,2022,30440000
M,20700000,25640000,GYEONGGI,2022,46340000
M,19110000,10280000,4146510700,2021,29390000
M,10290000,15190000,4146510700,2020,25480000
F,9980000,5310000,4146510700,2020,15290000
F,180000,1510000,GANGWON,2021,1690000
M,23890000,27370000,GYEONGGI,2024,51260000
M,28270000,19430000,4280000000,2024,47700000
M,32650000,40000,4399000000,2020,32690000
M,27500000,14140000,4146510700,2024,41640000
M,12750000,18210000,4273000000,2024,30960000
F,24950000,17430000,4111100000,2024,42380000
F,7750000,1550000,GANGWON,2020,9300000
F,20630000,13210000,4279000000,2024,33840000
F,34610000,25810000,4146510700,2022,60420000
M,38850000,4730000,4399000000,2020,43580000
M,24370000,28340000,4273000000,2021,52710000
M,3930000,19710000,4111100000,2024,23640000
M,11890000,3760000,4291000000,2023,15650000
M,40480000,17080000,4211000000,2020,57560000
F,17350000,20860000,4273000000,2021,38210000
M,10750000,17960000,4280000000,2022,28710000
F,37840000,15570000,4273000000,2021,53410000
F,2050000,21510000,4273000000,2024,23560000
F,5020000,26580000,4280000000,2023,31600000
F,1980000,4610000,4291000000,2024,6590000
M,2560000,23240000,GANGWON,2021,25800000
F,37620000,14510000,GYEONGGI,2020,52130000
F,49790000,26870000,4111100000,2023,76660000
F,47060000,29210000,4273000000,2023,76270000
M,45270000,27900000,4273000000,2021,73170000
M,40180000,1550000,4280000000,2024,41730000
M,34440000,13420000,4399000000,2021,47860000
F,27370000,10890000,4273000000,2023,38260000
F,1550000,21160000,4273000000,2021,22710000
M,27390000,2900000,4280000000,2023,30290000
F,41750000,18420000,4399000000,2024,60170000
M,41250000,7060000,4280000000,2020,48310000
M,39490000,24330000,GANGWON,2020,63820000
F,19450000,20390000,4273000000,2021,39840000
F,41320000,22290000,4146510700,2023,63610000
F,33330000,22460000,4111100000,2020,55790000
F,8830000,24560000,4399000000,2023,33390000
M,34040000,9190000,4146510700,2024,43230000
M,36740000,28150000,4280000000,2021,64890000
M,13200000,29990000,4273000000,2023,43190000
M,39750000,660000,4280000000,2021,40410000
M,31800000,4600000,GYEONGGI,2023,36400000
F,41170000,18790000,GYEONGGI,2023,59960000
M,31140000,11460000,GANGWON,2024,42600000
M,8790000,4870000,4273000000,2021,13660000
M,42810000,18830000,4273000000,2022,61640000
F,1300000,29810000,4146510700,2023,31110000
F,5480000,27110000,4279000000,2023,32590000
F,25580000,4260000,4273000000,2020,29840000
F,43570000,2300000,GANGWON,2021,45870000
M,41990000,4010000,4399000000,2022,46000000
M,15590000,10430000,4399000000,2024,26020000
F,13980000,18100000,4280000000,2022,32080000
F,28020000,24280000,4146510700,2024,52300000
M,2340000,29640000,4291000000,2022,31980000
M,39120000,26070000,4211000000,2022,65190000
F,47290000,9270000,4280000000,2021,56560000
F,32710000,10340000,4273000000,2020,43050000
F,4420000,28440000,4280000000,2022,32860000
F,45500000,15000000,4291000000,2023,60500000
M,39970000,27440000,4211000000,2023,67410000
M,13710000,29770000,4291000000,2023,43480000
M,16860000,1880000,4291000000,2020,18740000
F,44410000,3910000,GYEONGGI,2022,48320000
F,45920000,12990000,4399000000,2024,58910000
M,47000000,26840000,4279000000,2024,73840000
M,45800000,20320000,4273000000,2021,66120000
M,17070000,27640000,GANGWON,2020,44710000
M,23620000,760000,4146510700,2022,24380000
F,12540000,22040000,4280000000,2023,34580000
M,20410000,29390000,4273000000,2020,49800000
M,31280000,24940000,GYEONGGI,2020,56220000
M,1440000,19490000,4399000000,2022,20930000
M,31520000,29310000,4280000000,2021,60830000
M,23540000,8970000,4146510700,2021,32510000
M,25780000,7180000,4279000000,2021,32960000
M,12470000,320000,4273000000,2023,12790000
F,10640000,22130000,GANGWON,2023,32770000
F,27890000,26090000,4399000000,2022,53980000
F,34740000,3820000,4111100000,2021,38560000
F,4150000,26570000,4273000000,2022,30720000
M,23690000,19200000,4291000000,2021,42890000
F,23480000,13320000,4291000000,2020,36800000
F,14490000,24160000,GANGWON,2024,38650000
M,37360000,16800000,4211000000,2024,54160000
M,32200000,5110000,GANGWON,2021,37310000
F,29070000,24480000,4399000000,2022,53550000
F,2650000,650000,4291000000,2023,3300000
M,34710000,14990000,4279000000,2021,49700000
F,8700000,10770000,4279000000,2021,19470000
M,29300000,17660000,4291000000,2023,46960000
M,46170000,20850000,4399000000,2021,67020000
M,25510000,10270000,GYEONGGI,2020,35780000
M,33180000,25030000,4146510700,2023,58210000
F,44920000,3500000,4146510700,2020,48420000
M,38800000,28620000,4399000000,2024,67420000
M,19700000,7980000,4111100000,2023,27680000
F,20100000,16380000,4146510700,2023,36480000
M,21650000,16980000,4280000000,2022,38630000
F,16090000,17540000,4146510700,2022,33630000
F,45410000,26830000,4280000000,2023,72240000
F,34960000,16000000,4291000000,2024,50960000
M,49170000,29900000,GYEONGGI,2021,79070000
F,41600000,20540000,GANGWON,2022,62140000
F,9750000,29520000,GYEONGGI,2024,39270000
M,22020000,8860000,4146510700,2024,30880000
F,39750000,26820000,4146510700,2022,66570000
F,48540000,25170000,4399000000,2021,73710000
F,1560000,22840000,GANGWON,2022,24400000
F,26290000,3930000,4146510700,2024,30220000
F,5180000,19870000,4211000000,2020,25050000
M,41050000,7280000,4211000000,2022,48330000
F,38680000,2650000,4111100000,2024,41330000
F,43870000,28720000,4291000000,2022,72590000
M,43920000,27530000,4280000000,2024,71450000
M,20340000,200000,GYEONGGI,2021,20540000
M,30310000,18990000,4291000000,2024,49300000
F,15950000,14380000,4280000000,2023,30330000
M,21690000,20760000,4280000000,2020,42450000
F,26870000,25070000,4273000000,2024,51940000
F,41290000,19790000,4146510700,2022,61080000
M,17680000,23330000,4111100000,2022,41010000
M,27110000,12520000,4146510700,2024,39630000
F,15340000,10520000,4111100000,2023,25860000
M,25190000,12500000,4291000000,2024,37690000
F,6240000,24670000,4399000000,2021,30910000
M,29910000,18470000,4399000000,2023,48380000
M,12850000,25060000,4291000000,2024,37910000
M,29830000,13360000,GANGWON,2020,43190000
F,15880000,27120000,4211000000,2023,43000000
M,18230000,10120000,4280000000,2024,28350000
F,18230000,26810000,4111100000,2020,45040000
F,18200000,15270000,4279000000,2024,33470000
F,30430000,29390000,4146510700,2021,59820000
F,37680000,7010000,4291000000,2022,44690000
M,13020000,3830000,4280000000,2024,16850000
F,23910000,4020000,4111100000,2023,27930000
F,21700000,2780000,GYEONGGI,2024,24480000
M,31470000,11000000,GANGWON,2024,42470000
F,40320000,3030000,4146510700,2024,43350000
M,20630000,17920000,4399000000,2024,38550000
F,40650000,1590000,4291000000,2023,42240000
M,36600000,10450000,4399000000,2023,47050000
F,6910000,19890000,4111100000,2024,26800000
M,24690000,8050000,4399000000,2022,32740000
F,15820000,21600000,4146510700,2024,37420000
F,40060000,3240000,4211000000,2023,43300000
M,6250000,22650000,4280000000,2021,28900000
M,48590000,15700000,4211000000,2024,64290000
M,26090000,19810000,4291000000,2024,45900000
M,23190000,620000,4211000000,2024,23810000
F,34360000,10880000,4273000000,2024,45240000
F,16630000,11230000,4280000000,2020,27860000
M,10600000,18050000,4111100000,2024,28650000
F,28110000,4620000,4280000000,2023,32730000
M,18970000,15650000,4273000000,2023,34620000
M,48350000,21200000,4279000000,2020,69550000
F,35040000,11900000,4211000000,2024,46940000
F,39020000,4360000,4280000000,2022,43380000
F,19780000,980000,4399000000,2024,20760000
F,37700000,290000,4111100000,2023,37990000
F,26950000,14780000,GYEONGGI,2021,41730000
F,60000,10960000,4291000000,2021,11020000
F,16950000,10770000,4291000000,2022,27720000
M,27080000,11270000,4291000000,2024,38350000
M,25280000,28390000,4280000000,2020,53670000
M,21970000,14850000,4211000000,2024,36820000
M,40780000,11080000,4280000000,2022,51860000
M,23460000,9880000,4146510700,2022,33340000
F,36750000,26960000,4399000000,2022,63710000
M,43640000,1590000,GYEONGGI,2021,45230000
M,19550000,28900000,GYEONGGI,2024,48450000
M,2310000,10450000,4399000000,2024,12760000
M,37040000,28810000,4273000000,2020,65850000
M,10940000,6310000,GANGWON,2022,17250000
M,12060000,9390000,4146510700,2022,21450000
M,7300000,6400000,4111100000,2023,13700000
F,6290000,8150000,GYEONGGI,2023,14440000
F,9470000,21810000,4291000000,2021,31280000
M,2420000,23930000,4280000000,2024,26350000
F,33590000,27940000,4273000000,2020,61530000
F,42110000,7450000,GANGWON,2020,49560000
F,14700000,25480000,4399000000,2022,40180000
F,28830000,10300000,4279000000,2020,39130000
M,5520000,20320000,4111100000,2022,25840000
F,40400000,20560000,GANGWON,2024,60960000
F,41500000,25210000,4291000000,2020,66710000
F,25660000,10880000,GANGWON,2022,36540000
M,25490000,4520000,GYEONGGI,2024,30010000
M,3770000,18990000,4280000000,2024,22760000
M,31270000,10050000,4399000000,2022,41320000
M,42210000,29690000,GANGWON,2022,71900000
M,4580000,17260000,4111100000,2021,21840000
M,47610000,16860000,GANGWON,2024,64470000
M,39450000,22360000,4279000000,2022,61810000
F,21750000,890000,4273000000,2024,22640000
F,1770000,15090000,GYEONGGI,2020,16860000
F,48290000,15970000,4280000000,2023,64260000
M,7560000,23280000,4291000000,2023,30840000
M,21700000,8920000,4399000000,2022,30620000
M,32120000,8040000,4399000000,2022,40160000
M,26440000,26090000,4273000000,2024,52530000
M,500000,10430000,4211000000,2022,10930000
F,2180000,22290000,4211000000,2024,24470000
F,39810000,25060000,4291000000,2022,64870000
M,2070000,20710000,GANGWON,2024,22780000
M,5220000,25580000,4279000000,2022,30800000
M,27340000,24000000,4399000000,2021,51340000
M,280000,26720000,GANGWON,2024,27000000
F,580000,10010000,4399000000,2021,10590000
M,15350000,1520000,4399000000,2021,16870000
M,16760000,29780000,GANGWON,2021,46540000
M,4720000,14290000,4273000000,2021,19010000
M,16740000,10550000,4211000000,2020,27290000
F,15840000,29750000,4146510700,2023,45590000
M,21550000,29300000,4111100000,2020,50850000
M,23110000,20110000,4273000000,2022,43220000
F,13330000,29140000,GYEONGGI,2022,42470000
F,35240000,7710000,4279000000,2023,42950000
F,30180000,28410000,4279000000,2023,58590000
M,19830000,11470000,4111100000,2023,31300000
M,17370000,18910000,4279000000,2021,36280000
F,33950000,21340000,GANGWON,2020,55290000
F,36630000,19190000,4279000000,2022,55820000
F,34590000,6150000,4146510700,2020,40740000
F,13620000,27870000,4279000000,2020,41490000
F,30410000,27120000,4399000000,2020,57530000
F,28890000,15040000,4273000000,2023,43930000
M,35170000,2330000,GANGWON,2023,37500000
M,3430000,11010000,4211000000,2022,14440000
M,10220000,1920000,4279000000,2022,12140000
F,43010000,2070000,4291000000,2022,45080000
F,21210000,27180000,4291000000,2020,48390000
F,38400000,21760000,4291000000,2023,60160000
F,24100000,10530000,4279000000,2021,34630000
F,40360000,21110000,GYEONGGI,2020,61470000
F,9270000,9460000,4399000000,2024,18730000
M,39140000,1270000,4280000000,2020,40410000
M,7430000,3030000,4279000000,2023,10460000
F,3050000,690000,GYEONGGI,2024,3740000
M,29310000,4040000,4280000000,2020,33350000
F,18190000,25340000,4111100000,2023,43530000
M,33960000,26910000,4146510700,2023,60870000
F,33270000,23410000,4399000000,2021,56680000
F,6810000,19120000,4279000000,2020,25930000
M,46270000,28990000,4273000000,2023,75260000
M,17920000,25770000,GANGWON,2022,43690000
F,40010000,22730000,4273000000,2023,62740000
F,24890000,6030000,4273000000,2021,30920000
M,40550000,26390000,4111100000,2023,66940000
M,2470000,13320000,GANGWON,2020,15790000
F,34250000,20120000,4111100000,2020,54370000
M,25250000,23130000,4280000000,2024,48380000
F,15390000,12340000,4111100000,2020,27730000
F,38170000,19420000,4291000000,2024,57590000
F,9440000,8180000,4146510700,2022,17620000
F,33740000,1650000,4291000000,2021,35390000
M,32580000,21220000,4279000000,2022,53800000
M,32250000,26510000,4280000000,2024,58760000
M,49250000,21790000,GYEONGGI,2023,71040000
M,30890000,17540000,4280000000,2023,48430000
M,43860000,24850000,GYEONGGI,2022,68710000
M,12990000,4070000,4146510700,2023,17060000
M,37450000,660000,4111100000,2024,38110000
F,26570000,8960000,4111100000,2021,35530000
M,49980000,18360000,GANGWON,2020,68340000
M,39050000,10190000,4279000000,2024,49240000
F,4100000,13700000,4273000000,2024,17800000
M,28260000,25410000,4211000000,2020,53670000
M,44670000,3890000,4280000000,2020,48560000
F,8430000,22130000,4280000000,2021,30560000
M,45940000,2870000,4279000000,2021,48810000
M,13470000,8990000,4291000000,2021,22460000
M,43290000,21510000,4399000000,2023,64800000
F,47890000,8670000,4279000000,2024,56560000
M,19790000,23310000,4211000000,2020,43100000
M,2110000,2640000,4111100000,2024,4750000
F,27600000,16510000,GYEONGGI,2024,44110000
M,40370000,27140000,4291000000,2021,67510000
F,870000,12530000,4291000000,2021,13400000
F,45770000,13350000,GANGWON,2024,59120000
M,23210000,11760000,4146510700,2021,34970000
F,5780000,6400000,4211000000,2023,12180000
F,30860000,5810000,4291000000,2020,36670000
M,13310000,3760000,4211000000,2024,17070000
F,44220000,17700000,4279000000,2020,61920000
F,11890000,1980000,GYEONGGI,2023,13870000
M,12690000,21970000,GYEONGGI,2021,34660000
M,11850000,16290000,4280000000,2022,28140000
M,32300000,17160000,4111100000,2023,49460000
F,46990000,19880000,4280000000,2022,66870000
M,20840000,18640000,4291000000,2020,39480000
F,23880000,19280000,4146510700,2024,43160000
F,48610000,15240000,4280000000,2021,63850000
F,1410000,1750000,4280000000,2023,3160000
F,21000000,19160000,4280000000,2021,40160000
F,49860000,3480000,4211000000,2022,53340000
F,4630000,27410000,4279000000,2022,32040000
F,42090000,5760000,4146510700,2024,47850000
M,25650000,2800000,GYEONGGI,2022,28450000
M,39550000,15320000,GANGWON,2024,54870000
F,24460000,9670000,4211000000,2023,34130000
F,17460000,19040000,4291000000,2024,36500000
M,49720000,5250000,4146510700,2022,54970000
F,41990000,13550000,GYEONGGI,2020,55540000
M,1680000,11430000,4146510700,2024,13110000
M,29990000,3040000,4399000000,2021,33030000
M,22000000,20900000,4399000000,2020,42900000
F,16520000,5090000,4280000000,2024,21610000
F,5950000,11590000,4280000000,2021,17540000
M,14910000,1660000,4399000000,2020,16570000
M,42440000,16230000,GANGWON,2024,58670000
M,36900000,9200000,GYEONGGI,2023,46100000
M,27380000,28490000,4291000000,2021,55870000
M,19420000,27630000,4111100000,2023,47050000
F,4170000,22420000,4111100000,2022,26590000
M,5450000,5210000,4211000000,2024,10660000
F,23640000,2910000,GANGWON,2024,26550000
M,11900000,7710000,GANGWON,2021,19610000
F,35320000,25030000,4291000000,2024,60350000
F,36120000,15780000,4146510700,2022,51900000
F,32530000,23050000,4111100000,2024,55580000
F,37150000,5570000,4146510700,2020,42720000
F,31170000,4880000,4146510700,2023,36050000
F,15210000,29980000,GANGWON,2022,45190000
M,39100000,26180000,4146510700,2022,65280000
F,41450000,20680000,4111100000,2023,62130000
M,6090000,13900000,GYEONGGI,2023,19990000
F,38900000,11650000,4273000000,2022,50550000
F,1190000,23240000,4146510700,2023,24430000
M,14510000,10310000,4291000000,2021,24820000
F,29600000,17560000,4279000000,2023,47160000
M,30760000,2420000,4280000000,2020,33180000
M,10670000,5310000,4291000000,2020,15980000
M,14300000,12420000,4399000000,2021,26720000
M,47320000,6550000,4111100000,2023,53870000
F,15600000,14500000,4279000000,2020,30100000
F,1460000,560000,4280000000,2024,2020000
M,43210000,270000,4291000000,2023,43480000
F,11400000,22280000,4279000000,2021,33680000
F,33690000,5580000,4273000000,2023,39270000
M,49790000,4730000,4111100000,2022,54520000
F,30400000,29690000,GYEONGGI,2022,60090000
M,34740000,20670000,4211000000,2020,55410000
M,42280000,10120000,GANGWON,2022,52400000
F,15110000,22150000,4273000000,2021,37260000
F,44370000,11670000,4399000000,2020,56040000
F,43120000,20020000,GANGWON,2021,63140000
M,41390000,3990000,GYEONGGI,2021,45380000
M,46990000,2810000,4273000000,2022,49800000
F,47290000,6900000,4280000000,2022,54190000
F,19260000,29980000,4279000000,2021,49240000
F,40390000,1730000,4111100000,2022,42120000
F,33320000,29440000,4279000000,2022,62760000
M,21950000,16070000,4146510700,2022,38020000
F,36180000,26000000,4291000000,2023,62180000
M,13180000,10620000,4399000000,2021,23800000
M,15610000,16460000,4146510700,2024,32070000
F,4770000,8670000,4146510700,2021,13440000
F,27200000,23680000,4399000000,2020,50880000
F,27180000,15190000,4291000000,2022,42370000
M,15210000,22910000,4280000000,2022,38120000
F,10350000,15480000,4291000000,2024,25830000
F,23980000,27500000,4111100000,2020,51480000
M,37410000,1630000,4279000000,2023,39040000
F,11910000,14930000,4280000000,2021,26840000
M,20900000,12390000,4211000000,2023,33290000
F,2650000,10400000,4279000000,2020,13050000
M,48180000,10200000,4280000000,2024,58380000
F,43070000,29110000,4291000000,2020,72180000
F,47370000,2880000,4399000000,2024,50250000
M,37820000,1740000,4291000000,2023,39560000
M,39240000,29510000,4211000000,2023,68750000
F,41670000,21670000,4280000000,2020,63340000
M,10170000,1020000,4111100000,2020,11190000
M,5450000,15390000,4291000000,2022,20840000
M,41120000,18660000,4280000000,2024,59780000
M,4010000,5520000,4279000000,2022,9530000
F,2870000,3110000,4211000000,2021,5980000
F,10210000,7300000,4111100000,2021,17510000
M,14570000,4000000,4280000000,2020,18570000
M,32400000,15390000,4273000000,2023,47790000
M,39350000,16190000,4291000000,2021,55540000
M,24740000,29610000,4211000000,2021,54350000
F,41590000,830000,4111100000,2022,42420000
F,15630000,800000,4111100000,2022,16430000
M,48970000,12970000,4146510700,2021,61940000
M,18370000,6500000,GANGWON,2020,24870000
M,43760000,11950000,4211000000,2022,55710000
F,30070000,16180000,4111100000,2021,46250000
M,8190000,6470000,4280000000,2023,14660000
F,37980000,20700000,4146510700,2022,58680000
M,2460000,4360000,GANGWON,2021,6820000
F,130000,20350000,4279000000,2024,20480000
M,38700000,8040000,4280000000,2022,46740000
F,43920000,4290000,4291000000,2024,48210000
M,32130000,28150000,GANGWON,2022,60280000
M,19240000,20920000,4211000000,2022,40160000
M,32600000,25470000,4291000000,2024,58070000
F,38860000,1770000,GYEONGGI,2020,40630000
M,11920000,23140000,GYEONGGI,2021,35060000
F,31780000,9590000,4211000000,2020,41370000
F,16230000,7250000,4279000000,2020,23480000
M,19350000,12930000,GANGWON,2021,32280000
M,47700000,29870000,4146510700,2023,77570000
M,13930000,12360000,4273000000,2020,26290000
F,35050000,22290000,4111100000,2020,57340000
M,26780000,920000,4273000000,2020,27700000
F,29770000,3420000,GYEONGGI,2023,33190000
F,8580000,3400000,GYEONGGI,2022,11980000
M,38830000,10720000,4279000000,2024,49550000
M,21380000,16140000,4273000000,2024,37520000
M,43020000,15100000,4273000000,2023,58120000
M,19150000,9570000,4146510700,2020,28720000
M,29960000,14160000,4279000000,2024,44120000
M,25440000,8800000,4279000000,2023,34240000
F,5210000,12280000,4211000000,2021,17490000
F,48520000,19610000,4291000000,2024,68130000
F,10380000,16460000,4279000000,2021,26840000
M,12430000,29040000,4279000000,2020,41470000
F,12510000,25170000,4280000000,2024,37680000
F,21560000,21830000,GANGWON,2023,43390000
F,6860000,26630000,GANGWON,2022,33490000
F,12710000,24190000,4399000000,2024,36900000
F,34550000,2950000,4273000000,2024,37500000
M,28360000,19960000,4111100000,2024,48320000
M,2670000,21810000,4273000000,2024,24480000
F,40900000,10310000,4211000000,2023,51210000
F,14220000,19750000,4211000000,2023,33970000
F,48070000,13010000,4211000000,2022,61080000
M,2970000,3760000,4291000000,2023,6730000
M,19710000,8670000,4111100000,2023,28380000
F,45900000,25180000,GANGWON,2020,71080000
M,32320000,26290000,4146510700,2020,58610000
M,33110000,8320000,GANGWON,2021,41430000
F,38090000,29310000,4291000000,2022,67400000
M,24920000,24490000,4211000000,2020,49410000
M,20010000,22200000,4291000000,2022,42210000
F,2710000,9260000,GANGWON,2022,11970000
M,770000,20250000,4146510700,2024,21020000
M,44300000,28520000,4399000000,2022,72820000
F,11760000,9230000,4111100000,2024,20990000
M,30720000,12620000,4291000000,2021,43340000
M,35260000,23690000,GANGWON,2021,58950000
F,22740000,25110000,4111100000,2021,47850000
F,31760000,21170000,GANGWON,2024,52930000
F,17740000,4620000,GANGWON,2024,22360000
M,14280000,25370000,4146510700,2021,39650000
F,44520000,12680000,4399000000,2024,57200000
M,1570000,21990000,4111100000,2023,23560000
F,43750000,14980000,4211000000,2023,58730000
M,25430000,5550000,4111100000,2024,30980000
F,43560000,23440000,4279000000,2024,67000000
F,28960000,15110000,4211000000,2020,44070000
F,14910000,6860000,4111100000,2020,21770000
F,31010000,29720000,4280000000,2022,60730000
M,17440000,7560000,4280000000,2022,25000000
F,44270000,9470000,GANGWON,2022,53740000
F,49380000,21210000,4211000000,2021,70590000
M,42080000,2860000,4111100000,2023,44940000
F,7840000,13360000,GANGWON,2021,21200000
M,43220000,27220000,4273000000,2024,70440000
F,8040000,23860000,GANGWON,2020,31900000
F,14130000,6780000,4291000000,2024,20910000
F,45760000,21680000,4280000000,2024,67440000
M,23760000,2570000,4273000000,2020,26330000
F,32980000,27020000,GYEONGGI,2024,60000000
F,33200000,18030000,4291000000,2022,51230000
F,26660000,25050000,4211000000,2020,51710000
M,37560000,12210000,GANGWON,2024,49770000
M,31280000,29690000,4280000000,2022,60970000
F,2360000,9930000,4399000000,2022,12290000
M,17930000,3690000,4280000000,2023,21620000
F,44470000,12660000,4146510700,2022,57130000
F,34090000,14930000,4280000000,2021,49020000
F,4340000,28590000,4399000000,2020,32930000
F,41830000,18390000,4399000000,2020,60220000
F,5150000,17860000,GANGWON,2020,23010000
F,31940000,6440000,4211000000,2024,38380000
F,43480000,27370000,4399000000,2024,70850000
M,25280000,13770000,4280000000,2021,39050000
M,33960000,5920000,4211000000,2022,39880000
M,48420000,4670000,4111100000,2024,53090000
M,43600000,8130000,4280000000,2022,51730000
M,18430000,25730000,4279000000,2022,44160000
M,28870000,380000,GANGWON,2024,29250000
M,32050000,24380000,4291000000,2024,56430000
F,23250000,29230000,GANGWON,2021,52480000
F,18010000,25940000,4399000000,2023,43950000
F,5220000,13710000,GYEONGGI,2020,18930000
F,32500000,26330000,4146510700,2024,58830000
M,45820000,18540000,4279000000,2024,64360000
M,44360000,24880000,4399000000,2022,69240000
F,32590000,5520000,4280000000,2023,38110000
F,26460000,7240000,4211000000,2024,33700000
M,7770000,21900000,4279000000,2023,29670000
F,36680000,14650000,GYEONGGI,2020,51330000
F,9920000,1540000,4291000000,2022,11460000
F,20800000,3340000,4211000000,2021,24140000
F,46790000,22560000,4146510700,2020,69350000
M,18300000,23440000,4273000000,2023,41740000
F,31390000,28580000,4146510700,2023,59970000
F,35560000,29270000,GANGWON,2020,64830000
M,21490000,15560000,4279000000,2023,37050000
M,45900000,23230000,GANGWON,2021,69130000
F,49270000,26730000,4399000000,2021,76000000
M,12920000,4290000,4111100000,2023,17210000
F,23390000,7750000,4399000000,2023,31140000
F,1460000,1190000,4291000000,2021,2650000
M,6370000,18320000,4279000000,2023,24690000
F,10460000,27440000,4111100000,2024,37900000
F,20710000,1950000,4211000000,2022,22660000
F,41180000,12770000,4111100000,2024,53950000
F,39410000,14580000,4291000000,2023,53990000
M,17500000,11330000,4280000000,2023,28830000
M,21850000,11590000,GANGWON,2022,33440000
F,22800000,760000,GYEONGGI,2023,23560000
M,14050000,4500000,4399000000,2022,18550000
F,9580000,19100000,4279000000,2021,28680000
F,42970000,430000,4291000000,2022,43400000
F,27610000,11950000,4273000000,2022,39560000
F,3870000,27080000,GYEONGGI,2024,30950000
F,21810000,16370000,4291000000,2023,38180000
M,26380000,6070000,4273000000,2021,32450000
F,13860000,19610000,4273000000,2020,33470000
M,16260000,1160000,4273000000,2022,17420000
M,13390000,25680000,4280000000,2020,39070000
F,22810000,20560000,4111100000,2023,43370000
F,37650000,26650000,4146510700,2022,64300000
F,26850000,23790000,4399000000,2020,50640000
F,18160000,2930000,4273000000,2024,21090000
F,4540000,3830000,4291000000,2020,8370000
M,44510000,13710000,4211000000,2024,58220000
F,25890000,10550000,4211000000,2021,36440000
F,45730000,8910000,4279000000,2023,54640000
M,15440000,17010000,GANGWON,2020,32450000
M,3770000,29680000,4273000000,2022,33450000
F,37640000,26030000,4291000000,2023,63670000
M,47550000,6870000,4273000000,2020,54420000
F,23540000,21180000,4280000000,2022,44720000
M,27560000,8450000,GANGWON,2022,36010000
M,6890000,8800000,4273000000,2022,15690000
F,2450000,27530000,4399000000,2022,29980000
M,8050000,24810000,4211000000,2020,32860000
M,12190000,13790000,4273000000,2021,25980000
M,14040000,27050000,4399000000,2024,41090000
M,48010000,17710000,4399000000,2024,65720000
M,25470000,21160000,4111100000,2024,46630000
M,42100000,28440000,4399000000,2021,70540000
F,24360000,19740000,GANGWON,2022,44100000
F,7950000,27500000,4211000000,2022,35450000
M,20460000,10440000,4279000000,2023,30900000
F,47150000,19890000,4280000000,2024,67040000
F,15230000,26820000,4211000000,2024,42050000
F,43280000,7300000,4291000000,2022,50580000
M,24780000,23310000,4279000000,2024,48090000
F,35530000,15670000,4399000000,2022,51200000
M,6140000,22380000,4273000000,2022,28520000
F,36830000,26570000,4111100000,2022,63400000
M,800000,22870000,4279000000,2020,23670000
M,19770000,12410000,4291000000,2020,32180000
F,14770000,25180000,4291000000,2020,39950000
F,30290000,1650000,4279000000,2020,31940000
M,19470000,23020000,4111100000,2021,42490000
F,18540000,26870000,4399000000,2023,45410000
F,32670000,17210000,GANGWON,2023,49880000
F,27150000,25850000,4291000000,2022,53000000
M,9690000,15790000,4399000000,2024,25480000
M,5250000,22720000,GANGWON,2020,27970000
F,37410000,25660000,GANGWON,2023,63070000
F,12900000,22850000,4291000000,2023,35750000
F,34960000,21720000,4279000000,2020,56680000
M,44470000,5280000,GANGWON,2021,49750000
M,6180000,14190000,4273000000,2021,20370000
F,43540000,15920000,4211000000,2023,59460000
F,46410000,27570000,4280000000,2021,73980000
F,37120000,13070000,4291000000,2020,50190000
F,37220000,28810000,GYEONGGI,2023,66030000
F,34600000,25170000,GANGWON,2020,59770000
F,41370000,18920000,4146510700,2021,60290000
M,15510000,27270000,4273000000,2020,42780000
F,7870000,22280000,GYEONGGI,2021,30150000
M,46540000,28370000,4399000000,2021,74910000
F,37770000,2930000,4280000000,2020,40700000
F,42770000,7810000,4111100000,2021,50580000
M,2080000,21860000,GANGWON,2022,23940000
M,7830000,620000,4111100000,2020,8450000
M,27000000,17410000,4280000000,2022,44410000
M,4790000,16120000,4273000000,2020,20910000
F,16090000,8370000,4273000000,2021,24460000
M,27530000,1150000,4280000000,2021,28680000
F,29360000,9760000,4273000000,2023,39120000
M,45490000,24630000,GANGWON,2023,70120000
F,24500000,15290000,4280000000,2022,39790000
F,45940000,6230000,4291000000,2021,52170000
F,23580000,20130000,4146510700,2023,43710000
F,46010000,3580000,4399000000,2021,49590000
F,6350000,22930000,4211000000,2020,29280000
F,18340000,20560000,4279000000,2023,38900000
M,20800000,5180000,4146510700,2022,25980000
F,30500000,29480000,4211000000,2023,59980000
M,7430000,12180000,4279000000,2021,19610000
M,18300000,27120000,4111100000,2024,45420000
F,26350000,29250000,4146510700,2024,55600000
M,38770000,28730000,GYEONGGI,2021,67500000
F,4960000,12070000,4146510700,2020,17030000
M,27980000,1350000,4273000000,2023,29330000
F,14390000,24420000,GANGWON,2024,38810000
M,7590000,8580000,GANGWON,2020,16170000
F,33220000,14950000,4211000000,2021,48170000
F,24420000,28750000,4273000000,2020,53170000
F,900000,14910000,4111100000,2021,15810000
F,16180000,14870000,GANGWON,2023,31050000
M,12210000,4470000,4399000000,2020,16680000
F,49290000,9570000,4111100000,2023,58860000
M,46470000,16380000,4273000000,2020,62850000
M,45360000,11350000,4273000000,2021,56710000
M,46800000,29900000,4211000000,2021,76700000
F,8280000,28570000,4291000000,2020,36850000
M,21580000,5750000,GANGWON,2021,27330000
M,10690000,10390000,4273000000,2022,21080000
M,34520000,19360000,4273000000,2022,53880000
F,8880000,25640000,4399000000,2023,34520000
F,28440000,2490000,4146510700,2022,30930000
M,22040000,17450000,4146510700,2022,39490000
F,5000000,26170000,4273000000,2024,31170000
F,36500000,24090000,4111100000,2024,60590000
M,10690000,4990000,4399000000,2024,15680000
M,1340000,29560000,4111100000,2024,30900000
F,8850000,2930000,4279000000,2021,11780000
M,10780000,15730000,4291000000,2023,26510000
F,34740000,190000,4146510700,2023,34930000
F,43630000,10100000,4146510700,2022,53730000
F,21870000,3480000,4399000000,2023,25350000
F,40960000,26980000,4280000000,2022,67940000
F,2260000,16670000,4111100000,2023,18930000
F,1790000,24150000,GANGWON,2020,25940000
M,9530000,10330000,4399000000,2020,19860000
M,43360000,21860000,4211000000,2023,65220000
F,49150000,4080000,4280000000,2021,53230000
F,33050000,1220000,GYEONGGI,2022,34270000
F,14510000,8290000,4111100000,2023,22800000
M,28410000,28070000,4280000000,2022,56480000
F,45520000,18710000,4399000000,2024,64230000
M,570000,18180000,GANGWON,2023,18750000
F,14490000,17530000,4211000000,2021,32020000
F,9400000,3550000,4291000000,2024,12950000
M,22670000,7290000,4280000000,2023,29960000
M,15070000,23900000,4291000000,2020,38970000
F,14240000,28850000,4273000000,2023,43090000
F,41160000,4350000,4146510700,2020,45510000
F,38800000,16560000,4279000000,2020,55360000
M,20650000,4560000,4146510700,2023,25210000
M,3300000,490000,GYEONGGI,2023,3790000
M,2820000,14730000,GANGWON,2020,17550000
M,3350000,2990000,4211000000,2022,6340000
M,10820000,25960000,4291000000,2024,36780000
M,48370000,7570000,4399000000,2021,55940000
F,45060000,6630000,4291000000,2023,51690000
F,1610000,25170000,GANGWON,2024,26780000
M,19070000,16910000,4399000000,2024,35980000
F,36570000,19720000,4399000000,2022,56290000
F,20080000,13500000,GYEONGGI,2024,33580000
M,36750000,3420000,GANGWON,2023,40170000
F,27660000,23100000,4280000000,2024,50760000
M,34390000,8190000,4146510700,2023,42580000
M,8100000,5080000,4273000000,2023,13180000
F,34100000,4750000,4291000000,2020,38850000
M,18860000,18100000,4280000000,2022,36960000
M,30830000,2620000,4273000000,2021,33450000
M,33460000,24770000,4211000000,2020,58230000
M,10110000,22710000,4279000000,2021,32820000
M,4300000,23980000,4291000000,2023,28280000
M,14300000,10520000,GYEONGGI,2020,24820000
M,36440000,7310000,4273000000,2024,43750000
M,25560000,440000,4399000000,2024,26000000
F,30420000,5300000,4280000000,2021,35720000
F,33030000,10950000,4146510700,2023,43980000
F,9000000,28180000,GYEONGGI,2021,37180000
M,24520000,29220000,4291000000,2022,53740000
M,7660000,8850000,GANGWON,2024,16510000
F,26650000,14120000,4280000000,2020,40770000
F,35280000,2640000,GYEONGGI,2020,37920000
F,9140000,1340000,4279000000,2020,10480000
M,21800000,6150000,4291000000,2024,27950000
F,31120000,25220000,4211000000,2023,56340000
F,6380000,3550000,4146510700,2024,9930000
M,40320000,19290000,4211000000,2024,59610000
F,34300000,24930000,4273000000,2020,59230000
M,15670000,27290000,GANGWON,2024,42960000
M,42410000,730000,4273000000,2020,43140000
M,40170000,21780000,4146510700,2023,61950000
F,15230000,1790000,4280000000,2022,17020000
F,12490000,10340000,4273000000,2020,22830000
M,24090000,9170000,GANGWON,2021,33260000
F,33550000,17700000,4111100000,2022,51250000
F,27740000,19570000,4111100000,2023,47310000
F,13550000,8770000,GYEONGGI,2022,22320000
F,33870000,22940000,GYEONGGI,2020,56810000
M,20670000,18670000,4291000000,2023,39340000
F,33890000,22620000,GYEONGGI,2021,56510000
M,20700000,680000,4279000000,2020,21380000
M,29710000,24200000,GYEONGGI,2020,53910000
F,42360000,24180000,4279000000,2023,66540000
M,35980000,8820000,GYEONGGI,2023,44800000
F,48700000,25870000,4211000000,2022,74570000
F,38110000,6920000,4399000000,2021,45030000
M,7460000,5380000,4279000000,2022,12840000
M,2790000,12170000,4280000000,2022,14960000
M,41160000,11550000,4291000000,2020,52710000
M,39110000,24130000,4146510700,2023,63240000
F,23170000,2240000,4279000000,2020,25410000
F,30530000,1320000,4273000000,2021,31850000
F,45560000,10710000,4399000000,2022,56270000
M,27880000,27730000,4211000000,2021,55610000
M,9070000,21450000,4111100000,2023,30520000
M,33390000,16770000,4211000000,2023,50160000
F,39130000,23830000,GYEONGGI,2024,62960000
M,34450000,5110000,4291000000,2021,39560000
F,44110000,5750000,4399000000,2020,49860000
M,8500000,1090000,4273000000,2021,9590000
F,1410000,13220000,4279000000,2022,14630000
F,18610000,9300000,4211000000,2023,27910000
M,30560000,12250000,4399000000,2023,42810000
M,10030000,21600000,4279000000,2021,31630000
F,34000000,8460000,4291000000,2021,42460000
F,42030000,18690000,4146510700,2021,60720000
M,18290000,15760000,4111100000,2022,34050000
M,18360000,12750000,4291000000,2022,31110000
F,43390000,22530000,GYEONGGI,2020,65920000
M,30780000,18310000,GANGWON,2021,49090000
F,47480000,29640000,4146510700,2020,77120000
F,36780000,12390000,GYEONGGI,2024,49170000
M,33430000,4580000,4211000000,2022,38010000
M,21450000,29150000,4146510700,2023,50600000
M,47330000,10870000,GYEONGGI,2024,58200000
M,28610000,16640000,4146510700,2023,45250000
M,20190000,12670000,4291000000,2024,32860000
F,24410000,9680000,4399000000,2020,34090000
F,24460000,16860000,4111100000,2020,41320000
M,31490000,15210000,4111100000,2022,46700000
M,43740000,15590000,GYEONGGI,2023,59330000
M,37170000,22840000,GYEONGGI,2024,60010000
F,27550000,24500000,4146510700,2021,52050000
M,48810000,8060000,4211000000,2021,56870000
M,20720000,24650000,GYEONGGI,2022,45370000
F,15110000,12940000,4146510700,2023,28050000
F,43830000,26290000,4280000000,2021,70120000
M,13020000,17870000,4111100000,2022,30890000
M,47230000,11080000,GYEONGGI,2022,58310000
M,34800000,3230000,4291000000,2023,38030000
F,28630000,10780000,4273000000,2021,39410000
M,17890000,28810000,4146510700,2021,46700000
M,7810000,4380000,4111100000,2021,12190000
M,48500000,25380000,GYEONGGI,2020,73880000
F,18280000,4160000,4399000000,2021,22440000
F,42250000,13740000,4146510700,2024,55990000
M,43030000,2610000,4211000000,2020,45640000
M,39830000,18770000,GYEONGGI,2020,58600000
F,21240000,17790000,4146510700,2020,39030000
F,9730000,13810000,GYEONGGI,2020,23540000
F,36380000,3270000,GANGWON,2022,39650000
F,47620000,28450000,4273000000,2024,76070000
F,4950000,10070000,4279000000,2023,15020000
F,8350000,21590000,4279000000,2021,29940000
F,29020000,8670000,GANGWON,2020,37690000
F,12610000,20100000,4146510700,2023,32710000
F,37290000,5930000,4211000000,2022,43220000
M,49270000,28480000,GYEONGGI,2023,77750000
M,42190000,26350000,4146510700,2020,68540000
M,22030000,2140000,4399000000,2024,24170000
F,13850000,10490000,4211000000,2023,24340000
M,43100000,23490000,4399000000,2020,66590000
F,49300000,2220000,GANGWON,2020,51520000
F,420000,630000,4291000000,2021,1050000
M,8290000,8750000,4279000000,2021,17040000
F,26520000,18990000,4279000000,2024,45510000
M,30660000,20030000,GYEONGGI,2021,50690000
M,33740000,10400000,4273000000,2024,44140000
M,19970000,8900000,GANGWON,2022,28870000
F,2210000,4590000,4146510700,2022,6800000
M,17980000,26460000,GANGWON,2021,44440000
F,36680000,29390000,4146510700,2022,66070000
M,5130000,5140000,GANGWON,2023,10270000
M,12970000,22170000,4291000000,2023,35140000
M,19490000,9860000,4280000000,2023,29350000
F,1480000,27210000,4273000000,2022,28690000
F,22630000,11280000,4146510700,2023,33910000
F,31900000,24600000,4273000000,2024,56500000
M,39480000,27950000,4211000000,2020,67430000
M,35990000,3560000,GANGWON,2021,39550000
F,6410000,24090000,GYEONGGI,2024,30500000
F,31120000,17030000,4111100000,2023,48150000
F,28310000,2870000,4211000000,2020,31180000
F,22360000,17910000,4399000000,2021,40270000
F,17880000,24210000,4279000000,2024,42090000
F,20070000,3860000,4111100000,2021,23930000
M,43710000,6100000,4291000000,2022,49810000
F,15440000,13780000,GANGWON,2023,29220000
M,24090000,16810000,4280000000,2024,40900000
M,12830000,16990000,4291000000,2024,29820000
F,42540000,2770000,4146510700,2020,45310000
F,43090000,25300000,4111100000,2020,68390000
M,12290000,670000,4279000000,2020,12960000
F,23100000,26710000,GYEONGGI,2021,49810000
F,10830000,23460000,4280000000,2023,34290000
M,25910000,6910000,4273000000,2021,32820000
M,10940000,1000000,GANGWON,2023,11940000
M,13810000,6610000,4146510700,2024,20420000
F,17600000,25850000,GANGWON,2021,43450000
M,30730000,10100000,4291000000,2021,40830000
F,35020000,22400000,4111100000,2021,57420000
M,2740000,3260000,4291000000,2022,6000000
M,20000000,20770000,4111100000,2023,40770000
M,24350000,14170000,GYEONGGI,2023,38520000
F,41110000,20600000,4279000000,2021,61710000
F,230000,25810000,4273000000,2022,26040000
M,12830000,23690000,GYEONGGI,2021,36520000
M,27220000,5010000,4211000000,2023,32230000
M,16580000,24800000,4279000000,2024,41380000
F,2400000,14740000,GYEONGGI,2022,17140000
M,1640000,23410000,4280000000,2022,25050000
F,43950000,23470000,GANGWON,2021,67420000
M,11790000,20460000,4291000000,2024,32250000
M,26570000,4480000,4279000000,2023,31050000
M,29340000,23730000,4280000000,2020,53070000
M,5050000,14610000,4291000000,2023,19660000
M,20000,9580000,4211000000,2023,9600000
M,34950000,1200000,4399000000,2024,36150000
F,27030000,6230000,4279000000,2022,33260000
M,36460000,17910000,4280000000,2023,54370000
F,10720000,9160000,4291000000,2022,19880000
M,49360000,23030000,4291000000,2024,72390000
M,25370000,28520000,GYEONGGI,2024,53890000
F,23600000,17300000,4111100000,2021,40900000
M,37390000,22390000,GYEONGGI,2020,59780000
F,24550000,25950000,4280000000,2024,50500000
F,14700000,15230000,4146510700,2024,29930000
M,22790000,24880000,GANGWON,2022,47670000
F,40670000,16780000,4279000000,2024,57450000
F,12450000,9930000,GYEONGGI,2023,22380000
M,38720000,20430000,4291000000,2021,59150000
F,4510000,15950000,4291000000,2021,20460000
M,9800000,22900000,4399000000,2023,32700000
M,31230000,6100000,4279000000,2024,37330000
M,26060000,7140000,4399000000,2020,33200000
M,30170000,16160000,GANGWON,2024,46330000
F,1000000,12060000,4211000000,2021,13060000
M,19270000,2600000,GYEONGGI,2020,21870000
M,26880000,26630000,4273000000,2022,53510000
F,31310000,11050000,4280000000,2022,42360000
M,23500000,22980000,4280000000,2024,46480000
M,30270000,27950000,4211000000,2024,58220000
F,40160000,17630000,4279000000,2020,57790000
F,17480000,20840000,GYEONGGI,2020,38320000
F,19540000,13740000,GANGWON,2024,33280000
F,41090000,16180000,4111100000,2021,57270000
F,28000000,11050000,4399000000,2022,39050000
F,7350000,3630000,4211000000,2020,10980000
F,16690000,28220000,4111100000,2021,44910000
M,39660000,20330000,4399000000,2024,59990000
F,17120000,1660000,4211000000,2023,18780000
F,25990000,2850000,4280000000,2020,28840000
F,43880000,24370000,4280000000,2023,68250000
M,33510000,26940000,4291000000,2021,60450000
M,15380000,25790000,4399000000,2022,41170000
F,14150000,16450000,4273000000,2021,30600000
F,23080000,24570000,GANGWON,2022,47650000
F,41680000,16100000,4146510700,2021,57780000
M,34400000,18930000,4279000000,2020,53330000
M,47580000,4070000,4279000000,2020,51650000
F,10680000,9530000,4399000000,2023,20210000
M,49060000,27650000,4211000000,2021,76710000
F,39890000,16610000,4211000000,2021,56500000
M,19760000,3910000,4146510700,2023,23670000
M,3400000,27840000,GANGWON,2024,31240000
F,11030000,10600000,GYEONGGI,2021,21630000
F,30740000,8170000,GANGWON,2021,38910000
F,12170000,2350000,GYEONGGI,2021,14520000
F,22290000,12870000,4146510700,2024,35160000
M,45640000,10200000,GYEONGGI,2020,55840000
M,25570000,18040000,4273000000,2023,43610000
M,46790000,16150000,4291000000,2024,62940000
F,5000000,23230000,GANGWON,2022,28230000
M,130000,2760000,GYEONGGI,2022,2890000
F,26210000,7060000,4280000000,2024,33270000
M,40480000,26540000,4273000000,2024,67020000
F,22360000,26420000,GANGWON,2020,48780000
F,12840000,20650000,GYEONGGI,2022,33490000
M,48590000,13700000,4280000000,2023,62290000
F,28330000,11560000,4146510700,2021,39890000
F,10780000,6050000,4146510700,2021,16830000
M,33440000,2230000,4399000000,2020,35670000
F,25130000,10030000,4279000000,2020,35160000
F,29980000,6130000,4111100000,2022,36110000
F,28570000,8390000,4280000000,2023,36960000
M,33910000,18340000,4399000000,2023,52250000
M,41120000,15910000,4273000000,2024,57030000
F,19500000,3970000,GYEONGGI,2020,23470000
M,47590000,24400000,GANGWON,2021,71990000
F,18370000,8600000,4211000000,2021,26970000
F,5980000,4740000,4280000000,2022,10720000
F,47940000,18330000,4111100000,2021,66270000
F,10460000,24030000,4211000000,2023,34490000
F,32010000,2950000,4291000000,2023,34960000
M,44500000,19050000,4111100000,2020,63550000
F,21000000,15030000,4399000000,2022,36030000
M,26420000,1130000,4111100000,2021,27550000
M,35450000,0,GYEONGGI,2020,35450000
F,2790000,8590000,GANGWON,2024,11380000
F,3140000,16900000,4273000000,2024,20040000
M,23640000,16200000,4211000000,2021,39840000
M,16330000,16220000,4111100000,2021,32550000
M,13050000,21330000,GYEONGGI,2021,34380000
F,35140000,21930000,4146510700,2023,57070000
M,20630000,27210000,4111100000,2021,47840000
F,48670000,19280000,4111100000,2024,67950000
F,24520000,24590000,4279000000,2021,49110000
F,23830000,5820000,4211000000,2022,29650000
M,27990000,27040000,4279000000,2024,55030000
F,46710000,27860000,4279000000,2022,74570000
F,29780000,550000,GANGWON,2024,30330000
F,28110000,25730000,GYEONGGI,2020,53840000
F,27760000,14880000,4279000000,2024,42640000
F,39780000,15140000,4111100000,2024,54920000
M,7580000,12180000,4399000000,2022,19760000
F,18790000,8580000,4399000000,2022,27370000
F,35230000,14140000,4146510700,2024,49370000
M,1000000,12840000,4399000000,2024,13840000
F,35730000,2870000,4146510700,2023,38600000
M,26580000,7910000,4399000000,2020,34490000
F,28780000,610000,4291000000,2020,29390000
M,46920000,8970000,4146510700,2021,55890000
M,17060000,25800000,4280000000,2024,42860000
F,15440000,2860000,4211000000,2024,18300000
F,10880000,10390000,4211000000,2024,21270000
F,48750000,1250000,4211000000,2024,50000000
M,12450000,910000,GYEONGGI,2020,13360000
M,2920000,21060000,GANGWON,2022,23980000
M,48480000,9470000,4273000000,2023,57950000
F,15700000,240000,GANGWON,2022,15940000
M,9750000,23490000,4146510700,2022,33240000
M,4790000,14820000,GANGWON,2020,19610000
F,1610000,18240000,4399000000,2023,19850000
M,24700000,22920000,4146510700,2024,47620000
M,15510000,23390000,GANGWON,2020,38900000
F,25550000,13450000,GANGWON,2020,39000000
M,6270000,22040000,4279000000,2023,28310000
F,37770000,14750000,4291000000,2021,52520000
F,42560000,4180000,GYEONGGI,2020,46740000
F,29800000,11500000,4146510700,2022,41300000
F,43570000,6830000,4273000000,2022,50400000
F,9830000,21050000,4211000000,2024,30880000
M,42810000,5230000,4111100000,2020,48040000
M,140000,15950000,4280000000,2024,16090000
F,15360000,1740000,GANGWON,2020,17100000
F,13720000,10760000,4211000000,2023,24480000
M,8450000,29330000,4399000000,2020,37780000
F,49470000,7660000,4280000000,2021,57130000
F,33490000,15760000,4291000000,2022,49250000
F,9750000,17360000,4211000000,2023,27110000
M,29160000,23940000,4279000000,2022,53100000
M,24660000,20750000,4211000000,2024,45410000
F,41330000,28470000,4291000000,2023,69800000
F,38260000,170000,4211000000,2021,38430000
M,35950000,21420000,GANGWON,2022,57370000
M,13620000,18950000,4211000000,2020,32570000
F,39920000,3680000,4279000000,2020,43600000
F,47860000,27700000,GYEONGGI,2020,75560000
M,40540000,8510000,4291000000,2023,49050000
M,41800000,18590000,4279000000,2021,60390000
M,40970000,20020000,4146510700,2021,60990000
F,35470000,2890000,4211000000,2021,38360000
M,1280000,25800000,4273000000,2022,27080000
F,42370000,1480000,4211000000,2023,43850000
M,49510000,1820000,4291000000,2020,51330000
M,19860000,18440000,4280000000,2022,38300000
M,20940000,14510000,4279000000,2021,35450000
M,25960000,21190000,4273000000,2020,47150000
F,14670000,10350000,4146510700,2023,25020000
F,14810000,7210000,4399000000,2024,22020000
M,23410000,5010000,4146510700,2021,28420000
F,41500000,12300000,4279000000,2021,53800000
M,18560000,2740000,4280000000,2021,21300000
M,30260000,25130000,4279000000,2021,55390000
M,10530000,14650000,4111100000,2020,25180000
M,46680000,17880000,4273000000,2023,64560000
F,3660000,15300000,4280000000,2022,18960000
M,8730000,12090000,4273000000,2020,20820000
M,41600000,24060000,4279000000,2023,65660000
F,4290000,21900000,GYEONGGI,2022,26190000
M,47620000,20560000,4273000000,2021,68180000
M,37590000,19080000,4111100000,2023,56670000
M,17630000,16980000,GANGWON,2021,34610000
F,7640000,23960000,4280000000,2023,31600000
M,46720000,10050000,4111100000,2024,56770000
F,1600000,17040000,4111100000,2021,18640000
M,19380000,2390000,4399000000,2021,21770000
M,19990000,25820000,GYEONGGI,2021,45810000
F,45220000,22320000,4211000000,2020,67540000
M,47980000,21510000,GYEONGGI,2022,69490000
M,16700000,10570000,4291000000,2021,27270000
F,23160000,27830000,4399000000,2021,50990000
F,27130000,12230000,4279000000,2020,39360000
F,8970000,2500000,4279000000,2020,11470000
F,46560000,3740000,4146510700,2024,50300000
F,29100000,25250000,4211000000,2023,54350000
M,46870000,110000,4291000000,2021,46980000
F,30880000,5110000,4273000000,2023,35990000
M,15370000,18120000,GYEONGGI,2020,33490000
M,42370000,12090000,4280000000,2020,54460000
M,14260000,26030000,4111100000,2024,40290000
F,6620000,540000,4273000000,2022,7160000
F,6040000,16590000,4146510700,2020,22630000
M,22650000,28600000,GYEONGGI,2021,51250000
F,25640000,20350000,4280000000,2024,45990000
F,34050000,24320000,4146510700,2022,58370000
F,20410000,14070000,4111100000,2024,34480000
F,10070000,20180000,4399000000,2020,30250000
M,31100000,10480000,4211000000,2022,41580000
M,43980000,27890000,4399000000,2023,71870000
F,29030000,19770000,4280000000,2022,48800000
M,26590000,20750000,4399000000,2021,47340000
F,3990000,23670000,4280000000,2023,27660000
F,8160000,18600000,4291000000,2023,26760000
M,38620000,27560000,4291000000,2021,66180000
M,27190000,22490000,GANGWON,2023,49680000
M,250000,8280000,GANGWON,2020,8530000
F,43000000,8480000,4399000000,2022,51480000
M,12960000,11160000,4279000000,2022,24120000
F,20140000,18110000,4399000000,2021,38250000
M,23510000,5400000,4399000000,2020,28910000
M,34530000,28190000,4279000000,2023,62720000
F,38820000,3700000,4211000000,2022,42520000
F,42970000,7970000,GYEONGGI,2022,50940000
F,420000,5930000,4279000000,2022,6350000
F,36950000,13190000,4280000000,2022,50140000
F,19030000,20660000,GYEONGGI,2024,39690000
F,42180000,15940000,4111100000,2021,58120000
F,28190000,12370000,4211000000,2023,40560000
F,47220000,19150000,4111100000,2023,66370000
M,33540000,23490000,GANGWON,2021,57030000
F,29550000,24370000,4273000000,2020,53920000
F,21370000,16950000,4291000000,2021,38320000
M,24050000,1190000,4111100000,2022,25240000
F,46980000,19450000,4146510700,2022,66430000
M,27960000,8300000,4399000000,2021,36260000
M,2750000,27410000,4280000000,2021,30160000
F,48480000,13500000,4111100000,2023,61980000
M,1000000,2940000,4111100000,2023,3940000
F,46150000,23250000,4273000000,2024,69400000
M,17840000,12400000,GANGWON,2024,30240000
M,48360000,1930000,4399000000,2022,50290000
M,1860000,17040000,4399000000,2024,18900000
F,12580000,13110000,4273000000,2024,25690000
F,32600000,28510000,4279000000,2020,61110000
M,24550000,13710000,4273000000,2021,38260000
M,45450000,12310000,4146510700,2023,57760000
F,45350000,26300000,GYEONGGI,2024,71650000
F,27090000,6490000,4146510700,2023,33580000
M,30140000,9540000,4273000000,2024,39680000
M,15860000,22230000,4291000000,2024,38090000
F,31610000,15190000,4279000000,2022,46800000
F,19130000,22590000,4291000000,2020,41720000
F,32580000,12090000,4146510700,2021,44670000
F,28350000,6110000,4399000000,2021,34460000
F,24010000,15100000,4146510700,2022,39110000
M,14840000,840000,4211000000,2022,15680000
F,19720000,9580000,GANGWON,2021,29300000
M,3290000,7740000,4280000000,2021,11030000
F,46550000,14110000,4211000000,2020,60660000
M,47530000,9270000,4273000000,2024,56800000
F,32880000,9980000,4111100000,2020,42860000
F,29260000,170000,4291000000,2021,29430000
M,15180000,3770000,GYEONGGI,2024,18950000
M,33420000,16210000,4211000000,2021,49630000
F,47800000,24410000,4279000000,2020,72210000
F,9170000,28750000,4291000000,2020,37920000
F,12890000,1530000,4211000000,2020,14420000
F,46630000,12700000,4399000000,2024,59330000
F,5490000,4730000,4280000000,2023,10220000
M,48230000,7520000,4146510700,2023,55750000
M,27360000,14330000,4146510700,2021,41690000
F,10190000,17810000,4211000000,2024,28000000
M,10890000,4620000,4273000000,2022,15510000
M,46980000,13330000,4279000000,2023,60310000
M,6290000,6840000,4273000000,2024,13130000
F,13600000,11830000,4291000000,2024,25430000
M,4050000,24230000,GANGWON,2023,28280000
F,7200000,19930000,4280000000,2024,27130000
M,42710000,8870000,4280000000,2024,51580000
F,47740000,4760000,4146510700,2023,52500000
M,28860000,22840000,4280000000,2020,51700000
F,7720000,27870000,4273000000,2021,35590000
F,7680000,18030000,4279000000,2022,25710000
M,18380000,9500000,4279000000,2021,27880000
F,19080000,10530000,4146510700,2020,29610000
F,26700000,7340000,4211000000,2020,34040000
F,5460000,16540000,4279000000,2024,22000000
F,2090000,20840000,4273000000,2021,22930000
F,24010000,26460000,4111100000,2020,50470000
F,18590000,13190000,4211000000,2021,31780000
F,16460000,24190000,GANGWON,2020,40650000
F,34670000,20570000,GYEONGGI,2022,55240000
M,26070000,26950000,4399000000,2020,53020000
M,23910000,12080000,4280000000,2021,35990000
F,12120000,1590000,4280000000,2024,13710000
F,16130000,18400000,4111100000,2021,34530000
M,32310000,2050000,4211000000,2023,34360000
M,41140000,18730000,4146510700,2021,59870000
M,45800000,15730000,4273000000,2022,61530000
F,150000,21430000,4111100000,2022,21580000
M,14990000,7390000,4399000000,2022,22380000
F,29620000,22930000,4279000000,2020,52550000
F,2480000,4070000,4146510700,2022,6550000
M,21900000,15480000,GYEONGGI,2021,37380000
F,45390000,5390000,4146510700,2024,50780000
F,39490000,13480000,4111100000,2022,52970000
F,45430000,4510000,GANGWON,2021,49940000
F,39390000,27280000,4111100000,2020,66670000
M,5080000,6900000,4111100000,2020,11980000
M,23710000,8440000,4111100000,2024,32150000
F,22550000,11860000,4146510700,2024,34410000
F,8770000,20660000,4111100000,2021,29430000
M,22070000,5900000,4211000000,2024,27970000
F,33970000,18940000,4146510700,2024,52910000
M,26320000,19530000,4279000000,2020,45850000
F,2990000,12420000,4211000000,2021,15410000
F,46280000,24460000,4399000000,2024,70740000
M,26040000,20970000,4279000000,2021,47010000
M,5350000,8770000,GYEONGGI,2022,14120000
M,7830000,29950000,4280000000,2020,37780000
M,26080000,16090000,4146510700,2020,42170000
F,35430000,20250000,4280000000,2020,55680000
M,35170000,28580000,4146510700,2023,63750000
F,1800000,25960000,4279000000,2021,27760000
M,8440000,4130000,GYEONGGI,2022,12570000
M,27350000,27020000,4273000000,2024,54370000
F,28720000,9330000,4273000000,2022,38050000
M,9390000,13340000,4211000000,2021,22730000
M,8220000,12320000,4111100000,2020,20540000
M,17560000,9970000,4111100000,2023,27530000
M,32650000,2080000,4273000000,2021,34730000
F,16490000,1360000,4279000000,2021,17850000
F,25110000,29090000,GYEONGGI,2024,54200000
M,26680000,3240000,4211000000,2022,29920000
M,9940000,25280000,4279000000,2022,35220000
M,44110000,29370000,4111100000,2024,73480000
F,29030000,24100000,4211000000,2023,53130000
F,1300000,9710000,4280000000,2020,11010000
F,27260000,8670000,4291000000,2020,35930000
F,28880000,25880000,4399000000,2023,54760000
M,22960000,15700000,4211000000,2024,38660000
M,43060000,20030000,4111100000,2021,63090000
M,36060000,25560000,4279000000,2022,61620000
F,30210000,21580000,4280000000,2021,51790000
M,34580000,13540000,4399000000,2022,48120000
F,35720000,3770000,4399000000,2021,39490000
F,20480000,18290000,4211000000,2024,38770000
M,8730000,28060000,4399000000,2024,36790000
M,47440000,16630000,4280000000,2023,64070000
M,7280000,11780000,GYEONGGI,2021,19060000
F,47960000,21620000,4279000000,2021,69580000
F,7010000,20170000,4211000000,2023,27180000
M,47730000,23500000,4399000000,2023,71230000
M,47240000,20180000,GYEONGGI,2024,67420000
F,45360000,18970000,4279000000,2024,64330000
M,36290000,2770000,4146510700,2021,39060000
F,33380000,21640000,GYEONGGI,2024,55020000
F,2500000,18420000,4146510700,2024,20920000
M,6170000,9350000,4146510700,2021,15520000
M,45580000,27930000,GYEONGGI,2023,73510000
M,26900000,21030000,4399000000,2021,47930000
M,49810000,8620000,4146510700,2020,58430000
F,46080000,5540000,4399000000,2021,51620000
F,170000,15160000,4399000000,2020,15330000
F,10780000,22550000,4279000000,2021,33330000
M,40900000,22020000,GANGWON,2020,62920000
F,1360000,18990000,4280000000,2020,20350000
M,15490000,70000,4399000000,2021,15560000
M,5880000,12040000,4279000000,2024,17920000
M,18380000,19750000,4291000000,2022,38130000
M,31640000,3780000,4146510700,2024,35420000
M,28430000,21730000,4211000000,2020,50160000
M,13810000,18750000,4399000000,2021,32560000
F,11310000,1940000,GYEONGGI,2021,13250000
M,6560000,19680000,4146510700,2021,26240000
F,40480000,25650000,4146510700,2021,66130000
F,48870000,22000000,4291000000,2022,70870000
M,1380000,24460000,4211000000,2023,25840000
M,36140000,20280000,4279000000,2020,56420000
M,35610000,28550000,4291000000,2022,64160000
F,25960000,6820000,4280000000,2024,32780000
M,31290000,1260000,4146510700,2023,32550000
F,13400000,29040000,4399000000,2023,42440000
M,27380000,14550000,4399000000,2021,41930000
M,21190000,12220000,4291000000,2022,33410000
F,33010000,26530000,4280000000,2024,59540000
F,19870000,10960000,4273000000,2021,30830000
M,19570000,2120000,4111100000,2021,21690000
F,17650000,19760000,GYEONGGI,2020,37410000
F,6000000,3070000,GYEONGGI,2023,9070000
F,31300000,2320000,4273000000,2024,33620000
F,42430000,11840000,4146510700,2023,54270000
F,37960000,13880000,4279000000,2022,51840000
M,10720000,22880000,4211000000,2020,33600000
M,19340000,10730000,4273000000,2021,30070000
F,47670000,1070000,4280000000,2020,48740000
M,46020000,24220000,4399000000,2021,70240000
M,22610000,16220000,4111100000,2020,38830000
F,11880000,22490000,4146510700,2021,34370000
M,30180000,11480000,4111100000,2023,41660000
F,39880000,16120000,4211000000,2023,56000000
F,41920000,28270000,4399000000,2023,70190000
M,24210000,9920000,4280000000,2023,34130000
F,1460000,1620000,GYEONGGI,2020,3080000
F,21120000,27570000,4211000000,2021,48690000
F,48140000,10620000,4273000000,2023,58760000
F,13590000,20440000,GYEONGGI,2020,34030000
F,40660000,29350000,GYEONGGI,2021,70010000
M,21100000,2910000,4280000000,2020,24010000
M,8660000,24740000,4273000000,2023,33400000
F,23710000,22960000,4291000000,2022,46670000
F,33310000,4120000,4211000000,2020,37430000
M,41280000,27630000,4279000000,2023,68910000
F,2700000,4860000,GANGWON,2024,7560000
M,26320000,20230000,4399000000,2021,46550000
F,22570000,380000,4280000000,2023,22950000
F,46660000,8920000,4399000000,2024,55580000
F,29610000,16410000,4211000000,2020,46020000
F,42090000,5600000,4273000000,2020,47690000
F,6940000,23540000,4279000000,2024,30480000
F,38200000,15850000,GANGWON,2024,54050000
